F001-AACCTCTC	AATGATACGGCGACCACCGAGATCTACACAACCTCTCTCGTCGGCAGCGTC
F002-CGATGGTA	AATGATACGGCGACCACCGAGATCTACACCGATGGTATCGTCGGCAGCGTC
F003-TGAAGTCG	AATGATACGGCGACCACCGAGATCTACACTGAAGTCGTCGTCGGCAGCGTC
F004-TCCATGGT	AATGATACGGCGACCACCGAGATCTACACTCCATGGTTCGTCGGCAGCGTC
F005-CTTCAACC	AATGATACGGCGACCACCGAGATCTACACCTTCAACCTCGTCGGCAGCGTC
F006-CAAGTCAT	AATGATACGGCGACCACCGAGATCTACACCAAGTCATTCGTCGGCAGCGTC
F007-GTGACTCT	AATGATACGGCGACCACCGAGATCTACACGTGACTCTTCGTCGGCAGCGTC
F008-ACTGGAAC	AATGATACGGCGACCACCGAGATCTACACACTGGAACTCGTCGGCAGCGTC
F009-AACCTAGG	AATGATACGGCGACCACCGAGATCTACACAACCTAGGTCGTCGGCAGCGTC
F010-CTGTGTAC	AATGATACGGCGACCACCGAGATCTACACCTGTGTACTCGTCGGCAGCGTC
F011-TGGAGACA	AATGATACGGCGACCACCGAGATCTACACTGGAGACATCGTCGGCAGCGTC
F012-ATGGAAGA	AATGATACGGCGACCACCGAGATCTACACATGGAAGATCGTCGGCAGCGTC
F013-GATCACCA	AATGATACGGCGACCACCGAGATCTACACGATCACCATCGTCGGCAGCGTC
F014-GTCTCGTT	AATGATACGGCGACCACCGAGATCTACACGTCTCGTTTCGTCGGCAGCGTC
F015-CCTACGTT	AATGATACGGCGACCACCGAGATCTACACCCTACGTTTCGTCGGCAGCGTC
F016-ACACACAC	AATGATACGGCGACCACCGAGATCTACACACACACACTCGTCGGCAGCGTC
F017-TGCAAGGA	AATGATACGGCGACCACCGAGATCTACACTGCAAGGATCGTCGGCAGCGTC
F018-TGTCTTGG	AATGATACGGCGACCACCGAGATCTACACTGTCTTGGTCGTCGGCAGCGTC
F019-CTTCACAT	AATGATACGGCGACCACCGAGATCTACACCTTCACATTCGTCGGCAGCGTC
F020-GAACACGT	AATGATACGGCGACCACCGAGATCTACACGAACACGTTCGTCGGCAGCGTC
F021-GGATGTCT	AATGATACGGCGACCACCGAGATCTACACGGATGTCTTCGTCGGCAGCGTC
F022-GTAGGAAG	AATGATACGGCGACCACCGAGATCTACACGTAGGAAGTCGTCGGCAGCGTC
F023-TCCTCATC	AATGATACGGCGACCACCGAGATCTACACTCCTCATCTCGTCGGCAGCGTC
F024-AAGAGGAA	AATGATACGGCGACCACCGAGATCTACACAAGAGGAATCGTCGGCAGCGTC
F025-AGGTTGAG	AATGATACGGCGACCACCGAGATCTACACAGGTTGAGTCGTCGGCAGCGTC
F026-ACACGATC	AATGATACGGCGACCACCGAGATCTACACACACGATCTCGTCGGCAGCGTC
F027-GAACGTAG	AATGATACGGCGACCACCGAGATCTACACGAACGTAGTCGTCGGCAGCGTC
F028-TCAGACGA	AATGATACGGCGACCACCGAGATCTACACTCAGACGATCGTCGGCAGCGTC
F029-CTGTCTCA	AATGATACGGCGACCACCGAGATCTACACCTGTCTCATCGTCGGCAGCGTC
F030-TCTGAAGT	AATGATACGGCGACCACCGAGATCTACACTCTGAAGTTCGTCGGCAGCGTC
F031-AACACAAG	AATGATACGGCGACCACCGAGATCTACACAACACAAGTCGTCGGCAGCGTC
F032-TTCTCCTA	AATGATACGGCGACCACCGAGATCTACACTTCTCCTATCGTCGGCAGCGTC
F033-CCTACAAG	AATGATACGGCGACCACCGAGATCTACACCCTACAAGTCGTCGGCAGCGTC
F034-TAGTGACT	AATGATACGGCGACCACCGAGATCTACACTAGTGACTTCGTCGGCAGCGTC
F035-AGTACGTA	AATGATACGGCGACCACCGAGATCTACACAGTACGTATCGTCGGCAGCGTC
F036-TTGCATCC	AATGATACGGCGACCACCGAGATCTACACTTGCATCCTCGTCGGCAGCGTC
F037-CTTGAAGG	AATGATACGGCGACCACCGAGATCTACACCTTGAAGGTCGTCGGCAGCGTC
F038-GCACTTGT	AATGATACGGCGACCACCGAGATCTACACGCACTTGTTCGTCGGCAGCGTC
F039-AACCAGAG	AATGATACGGCGACCACCGAGATCTACACAACCAGAGTCGTCGGCAGCGTC
F040-ACCATCCA	AATGATACGGCGACCACCGAGATCTACACACCATCCATCGTCGGCAGCGTC
F041-GCTTGTGT	AATGATACGGCGACCACCGAGATCTACACGCTTGTGTTCGTCGGCAGCGTC
F042-TGTCAAGC	AATGATACGGCGACCACCGAGATCTACACTGTCAAGCTCGTCGGCAGCGTC
F043-ATCTCACC	AATGATACGGCGACCACCGAGATCTACACATCTCACCTCGTCGGCAGCGTC
F044-ATCAGAGG	AATGATACGGCGACCACCGAGATCTACACATCAGAGGTCGTCGGCAGCGTC
F045-CGAGTGAA	AATGATACGGCGACCACCGAGATCTACACCGAGTGAATCGTCGGCAGCGTC
F046-CAGAGCTT	AATGATACGGCGACCACCGAGATCTACACCAGAGCTTTCGTCGGCAGCGTC
F047-CTAGAGAC	AATGATACGGCGACCACCGAGATCTACACCTAGAGACTCGTCGGCAGCGTC
F048-AACGACTG	AATGATACGGCGACCACCGAGATCTACACAACGACTGTCGTCGGCAGCGTC
F049-GATCATGG	AATGATACGGCGACCACCGAGATCTACACGATCATGGTCGTCGGCAGCGTC
F050-ACGATGAC	AATGATACGGCGACCACCGAGATCTACACACGATGACTCGTCGGCAGCGTC
F051-TTGGTCCA	AATGATACGGCGACCACCGAGATCTACACTTGGTCCATCGTCGGCAGCGTC
F052-ACCTGATG	AATGATACGGCGACCACCGAGATCTACACACCTGATGTCGTCGGCAGCGTC
F053-CGATGTAG	AATGATACGGCGACCACCGAGATCTACACCGATGTAGTCGTCGGCAGCGTC
F054-CTTCTCTC	AATGATACGGCGACCACCGAGATCTACACCTTCTCTCTCGTCGGCAGCGTC
F055-ACAGCTGT	AATGATACGGCGACCACCGAGATCTACACACAGCTGTTCGTCGGCAGCGTC
F056-GATCAGTC	AATGATACGGCGACCACCGAGATCTACACGATCAGTCTCGTCGGCAGCGTC
F057-CTGTTCAG	AATGATACGGCGACCACCGAGATCTACACCTGTTCAGTCGTCGGCAGCGTC
F058-TGTCGTCT	AATGATACGGCGACCACCGAGATCTACACTGTCGTCTTCGTCGGCAGCGTC
F059-TGAACACC	AATGATACGGCGACCACCGAGATCTACACTGAACACCTCGTCGGCAGCGTC
F060-CTTGTGAG	AATGATACGGCGACCACCGAGATCTACACCTTGTGAGTCGTCGGCAGCGTC
F061-ACTGCACA	AATGATACGGCGACCACCGAGATCTACACACTGCACATCGTCGGCAGCGTC
F062-CAACACTC	AATGATACGGCGACCACCGAGATCTACACCAACACTCTCGTCGGCAGCGTC
F063-TACGTGGA	AATGATACGGCGACCACCGAGATCTACACTACGTGGATCGTCGGCAGCGTC
F064-GTGAGTTG	AATGATACGGCGACCACCGAGATCTACACGTGAGTTGTCGTCGGCAGCGTC
F065-TGAGTCCT	AATGATACGGCGACCACCGAGATCTACACTGAGTCCTTCGTCGGCAGCGTC
F066-CACTCCAA	AATGATACGGCGACCACCGAGATCTACACCACTCCAATCGTCGGCAGCGTC
F067-AGGACTGT	AATGATACGGCGACCACCGAGATCTACACAGGACTGTTCGTCGGCAGCGTC
F068-GAGTGTGA	AATGATACGGCGACCACCGAGATCTACACGAGTGTGATCGTCGGCAGCGTC
F069-TGTTGCTG	AATGATACGGCGACCACCGAGATCTACACTGTTGCTGTCGTCGGCAGCGTC
F070-ACAGAAGC	AATGATACGGCGACCACCGAGATCTACACACAGAAGCTCGTCGGCAGCGTC
F071-CTCCAGTT	AATGATACGGCGACCACCGAGATCTACACCTCCAGTTTCGTCGGCAGCGTC
F072-TAGACTAC	AATGATACGGCGACCACCGAGATCTACACTAGACTACTCGTCGGCAGCGTC
F073-TTGTGAAG	AATGATACGGCGACCACCGAGATCTACACTTGTGAAGTCGTCGGCAGCGTC
F074-TACACAGC	AATGATACGGCGACCACCGAGATCTACACTACACAGCTCGTCGGCAGCGTC
F075-CTTGCATC	AATGATACGGCGACCACCGAGATCTACACCTTGCATCTCGTCGGCAGCGTC
F076-CGTGTTCT	AATGATACGGCGACCACCGAGATCTACACCGTGTTCTTCGTCGGCAGCGTC
F077-TCGTTCGA	AATGATACGGCGACCACCGAGATCTACACTCGTTCGATCGTCGGCAGCGTC
F078-GTTCTGTG	AATGATACGGCGACCACCGAGATCTACACGTTCTGTGTCGTCGGCAGCGTC
F079-AACCACGA	AATGATACGGCGACCACCGAGATCTACACAACCACGATCGTCGGCAGCGTC
F080-ACAACTCA	AATGATACGGCGACCACCGAGATCTACACACAACTCATCGTCGGCAGCGTC
F081-TGAAGCAC	AATGATACGGCGACCACCGAGATCTACACTGAAGCACTCGTCGGCAGCGTC
F082-TAGGATGG	AATGATACGGCGACCACCGAGATCTACACTAGGATGGTCGTCGGCAGCGTC
F083-CTGAGACT	AATGATACGGCGACCACCGAGATCTACACCTGAGACTTCGTCGGCAGCGTC
F084-GTCACAGA	AATGATACGGCGACCACCGAGATCTACACGTCACAGATCGTCGGCAGCGTC
F085-TCTGTCAA	AATGATACGGCGACCACCGAGATCTACACTCTGTCAATCGTCGGCAGCGTC
F086-ACAGGTTG	AATGATACGGCGACCACCGAGATCTACACACAGGTTGTCGTCGGCAGCGTC
F087-GTCTAGAG	AATGATACGGCGACCACCGAGATCTACACGTCTAGAGTCGTCGGCAGCGTC
F088-CACCTTGA	AATGATACGGCGACCACCGAGATCTACACCACCTTGATCGTCGGCAGCGTC
F089-ACCTGTCA	AATGATACGGCGACCACCGAGATCTACACACCTGTCATCGTCGGCAGCGTC
F090-TCACGAGT	AATGATACGGCGACCACCGAGATCTACACTCACGAGTTCGTCGGCAGCGTC
F091-GAACCTCA	AATGATACGGCGACCACCGAGATCTACACGAACCTCATCGTCGGCAGCGTC
F092-CATCAAGT	AATGATACGGCGACCACCGAGATCTACACCATCAAGTTCGTCGGCAGCGTC
F093-CATGTCGA	AATGATACGGCGACCACCGAGATCTACACCATGTCGATCGTCGGCAGCGTC
F094-AGCTCCTT	AATGATACGGCGACCACCGAGATCTACACAGCTCCTTTCGTCGGCAGCGTC
F095-TTGGTGTC	AATGATACGGCGACCACCGAGATCTACACTTGGTGTCTCGTCGGCAGCGTC
F096-ATGACTAG	AATGATACGGCGACCACCGAGATCTACACATGACTAGTCGTCGGCAGCGTC
F097-GAAGTTGA	AATGATACGGCGACCACCGAGATCTACACGAAGTTGATCGTCGGCAGCGTC
F098-CAGATCCA	AATGATACGGCGACCACCGAGATCTACACCAGATCCATCGTCGGCAGCGTC
F099-ATCCATCG	AATGATACGGCGACCACCGAGATCTACACATCCATCGTCGTCGGCAGCGTC
F100-CTCTACAC	AATGATACGGCGACCACCGAGATCTACACCTCTACACTCGTCGGCAGCGTC
F101-TACAGATG	AATGATACGGCGACCACCGAGATCTACACTACAGATGTCGTCGGCAGCGTC
F102-GGACAGTT	AATGATACGGCGACCACCGAGATCTACACGGACAGTTTCGTCGGCAGCGTC
F103-TCTCCAAC	AATGATACGGCGACCACCGAGATCTACACTCTCCAACTCGTCGGCAGCGTC
F104-TGTACTGA	AATGATACGGCGACCACCGAGATCTACACTGTACTGATCGTCGGCAGCGTC
F105-ACATCGTA	AATGATACGGCGACCACCGAGATCTACACACATCGTATCGTCGGCAGCGTC
F106-TGCAACAG	AATGATACGGCGACCACCGAGATCTACACTGCAACAGTCGTCGGCAGCGTC
F107-TACTGTAG	AATGATACGGCGACCACCGAGATCTACACTACTGTAGTCGTCGGCAGCGTC
F108-CAACAGCT	AATGATACGGCGACCACCGAGATCTACACCAACAGCTTCGTCGGCAGCGTC
F109-ATGATCGA	AATGATACGGCGACCACCGAGATCTACACATGATCGATCGTCGGCAGCGTC
F110-GTCCATGA	AATGATACGGCGACCACCGAGATCTACACGTCCATGATCGTCGGCAGCGTC
F111-CATGGTTG	AATGATACGGCGACCACCGAGATCTACACCATGGTTGTCGTCGGCAGCGTC
F112-TCGAGAAC	AATGATACGGCGACCACCGAGATCTACACTCGAGAACTCGTCGGCAGCGTC
F113-ATCGTCTT	AATGATACGGCGACCACCGAGATCTACACATCGTCTTTCGTCGGCAGCGTC
F114-TGACAACT	AATGATACGGCGACCACCGAGATCTACACTGACAACTTCGTCGGCAGCGTC
F115-TCATCTCC	AATGATACGGCGACCACCGAGATCTACACTCATCTCCTCGTCGGCAGCGTC
F116-GATGGTCA	AATGATACGGCGACCACCGAGATCTACACGATGGTCATCGTCGGCAGCGTC
F117-GATCTCAG	AATGATACGGCGACCACCGAGATCTACACGATCTCAGTCGTCGGCAGCGTC
F118-CTGATGTG	AATGATACGGCGACCACCGAGATCTACACCTGATGTGTCGTCGGCAGCGTC
F119-TGAGAAGG	AATGATACGGCGACCACCGAGATCTACACTGAGAAGGTCGTCGGCAGCGTC
F120-ACCTACAA	AATGATACGGCGACCACCGAGATCTACACACCTACAATCGTCGGCAGCGTC
F121-CCACAGTA	AATGATACGGCGACCACCGAGATCTACACCCACAGTATCGTCGGCAGCGTC
F122-TGCTCTCA	AATGATACGGCGACCACCGAGATCTACACTGCTCTCATCGTCGGCAGCGTC
F123-GTTCCTAC	AATGATACGGCGACCACCGAGATCTACACGTTCCTACTCGTCGGCAGCGTC
F124-CTAGGAGA	AATGATACGGCGACCACCGAGATCTACACCTAGGAGATCGTCGGCAGCGTC
F125-ATGTCCAC	AATGATACGGCGACCACCGAGATCTACACATGTCCACTCGTCGGCAGCGTC
F126-AAGCTTGC	AATGATACGGCGACCACCGAGATCTACACAAGCTTGCTCGTCGGCAGCGTC
F127-TAGATCTG	AATGATACGGCGACCACCGAGATCTACACTAGATCTGTCGTCGGCAGCGTC
F128-CCTAGCAT	AATGATACGGCGACCACCGAGATCTACACCCTAGCATTCGTCGGCAGCGTC
F129-GCATCATG	AATGATACGGCGACCACCGAGATCTACACGCATCATGTCGTCGGCAGCGTC
F130-CTCAACGT	AATGATACGGCGACCACCGAGATCTACACCTCAACGTTCGTCGGCAGCGTC
F131-AAGCTCAA	AATGATACGGCGACCACCGAGATCTACACAAGCTCAATCGTCGGCAGCGTC
F132-TGTAGTTC	AATGATACGGCGACCACCGAGATCTACACTGTAGTTCTCGTCGGCAGCGTC
F133-AAGGTCCT	AATGATACGGCGACCACCGAGATCTACACAAGGTCCTTCGTCGGCAGCGTC
F134-ACTTCAGC	AATGATACGGCGACCACCGAGATCTACACACTTCAGCTCGTCGGCAGCGTC
F135-GGATCACA	AATGATACGGCGACCACCGAGATCTACACGGATCACATCGTCGGCAGCGTC
F136-GGAAGGAA	AATGATACGGCGACCACCGAGATCTACACGGAAGGAATCGTCGGCAGCGTC
F137-AGTGCTAG	AATGATACGGCGACCACCGAGATCTACACAGTGCTAGTCGTCGGCAGCGTC
F138-AACAGGTC	AATGATACGGCGACCACCGAGATCTACACAACAGGTCTCGTCGGCAGCGTC
F139-CTCATCTA	AATGATACGGCGACCACCGAGATCTACACCTCATCTATCGTCGGCAGCGTC
F140-CACTAGTG	AATGATACGGCGACCACCGAGATCTACACCACTAGTGTCGTCGGCAGCGTC
F141-TCACATCG	AATGATACGGCGACCACCGAGATCTACACTCACATCGTCGTCGGCAGCGTC
F142-GTACAAGC	AATGATACGGCGACCACCGAGATCTACACGTACAAGCTCGTCGGCAGCGTC
F143-CAGTGGAT	AATGATACGGCGACCACCGAGATCTACACCAGTGGATTCGTCGGCAGCGTC
F144-GGAAGAGT	AATGATACGGCGACCACCGAGATCTACACGGAAGAGTTCGTCGGCAGCGTC
F145-GTACCTTG	AATGATACGGCGACCACCGAGATCTACACGTACCTTGTCGTCGGCAGCGTC
F146-TAGGTGAT	AATGATACGGCGACCACCGAGATCTACACTAGGTGATTCGTCGGCAGCGTC
F147-TCGTACAC	AATGATACGGCGACCACCGAGATCTACACTCGTACACTCGTCGGCAGCGTC
F148-CTTGAGCA	AATGATACGGCGACCACCGAGATCTACACCTTGAGCATCGTCGGCAGCGTC
F149-GGTTGAGA	AATGATACGGCGACCACCGAGATCTACACGGTTGAGATCGTCGGCAGCGTC
F150-ACAACAAC	AATGATACGGCGACCACCGAGATCTACACACAACAACTCGTCGGCAGCGTC
F151-AGCATCTG	AATGATACGGCGACCACCGAGATCTACACAGCATCTGTCGTCGGCAGCGTC
F152-AACATCGT	AATGATACGGCGACCACCGAGATCTACACAACATCGTTCGTCGGCAGCGTC
F153-GCTCTCTT	AATGATACGGCGACCACCGAGATCTACACGCTCTCTTTCGTCGGCAGCGTC
F154-AGAGGTAC	AATGATACGGCGACCACCGAGATCTACACAGAGGTACTCGTCGGCAGCGTC
F155-TCTCACAG	AATGATACGGCGACCACCGAGATCTACACTCTCACAGTCGTCGGCAGCGTC
F156-TCCACTTG	AATGATACGGCGACCACCGAGATCTACACTCCACTTGTCGTCGGCAGCGTC
F157-TGTTGGAC	AATGATACGGCGACCACCGAGATCTACACTGTTGGACTCGTCGGCAGCGTC
F158-CGAACTCT	AATGATACGGCGACCACCGAGATCTACACCGAACTCTTCGTCGGCAGCGTC
F159-ATGAACTC	AATGATACGGCGACCACCGAGATCTACACATGAACTCTCGTCGGCAGCGTC
F160-GAACGAGA	AATGATACGGCGACCACCGAGATCTACACGAACGAGATCGTCGGCAGCGTC
F161-AACCAACC	AATGATACGGCGACCACCGAGATCTACACAACCAACCTCGTCGGCAGCGTC
F162-TGATCGTT	AATGATACGGCGACCACCGAGATCTACACTGATCGTTTCGTCGGCAGCGTC
F163-ACCTTGGA	AATGATACGGCGACCACCGAGATCTACACACCTTGGATCGTCGGCAGCGTC
F164-CGTACTTG	AATGATACGGCGACCACCGAGATCTACACCGTACTTGTCGTCGGCAGCGTC
F165-TAGAGTGT	AATGATACGGCGACCACCGAGATCTACACTAGAGTGTTCGTCGGCAGCGTC
F166-AGATGCTC	AATGATACGGCGACCACCGAGATCTACACAGATGCTCTCGTCGGCAGCGTC
F167-GCTGAGAT	AATGATACGGCGACCACCGAGATCTACACGCTGAGATTCGTCGGCAGCGTC
F168-GTTGCTGA	AATGATACGGCGACCACCGAGATCTACACGTTGCTGATCGTCGGCAGCGTC
F169-GGATGAAC	AATGATACGGCGACCACCGAGATCTACACGGATGAACTCGTCGGCAGCGTC
F170-GCAGTGTA	AATGATACGGCGACCACCGAGATCTACACGCAGTGTATCGTCGGCAGCGTC
F171-ACGAACAG	AATGATACGGCGACCACCGAGATCTACACACGAACAGTCGTCGGCAGCGTC
F172-TGAGGTGT	AATGATACGGCGACCACCGAGATCTACACTGAGGTGTTCGTCGGCAGCGTC
F173-CACTGTCT	AATGATACGGCGACCACCGAGATCTACACCACTGTCTTCGTCGGCAGCGTC
F174-ATGGTACC	AATGATACGGCGACCACCGAGATCTACACATGGTACCTCGTCGGCAGCGTC
F175-ATGTCAGT	AATGATACGGCGACCACCGAGATCTACACATGTCAGTTCGTCGGCAGCGTC
F176-CATCTGTA	AATGATACGGCGACCACCGAGATCTACACCATCTGTATCGTCGGCAGCGTC
F177-GGTTCGAA	AATGATACGGCGACCACCGAGATCTACACGGTTCGAATCGTCGGCAGCGTC
F178-ATGCTCTG	AATGATACGGCGACCACCGAGATCTACACATGCTCTGTCGTCGGCAGCGTC
F179-GTCGTACT	AATGATACGGCGACCACCGAGATCTACACGTCGTACTTCGTCGGCAGCGTC
F180-CGAGACTT	AATGATACGGCGACCACCGAGATCTACACCGAGACTTTCGTCGGCAGCGTC
F181-TACTCTGT	AATGATACGGCGACCACCGAGATCTACACTACTCTGTTCGTCGGCAGCGTC
F182-GAGAGAAG	AATGATACGGCGACCACCGAGATCTACACGAGAGAAGTCGTCGGCAGCGTC
F183-TTCCTAGC	AATGATACGGCGACCACCGAGATCTACACTTCCTAGCTCGTCGGCAGCGTC
F184-TCGTGGAA	AATGATACGGCGACCACCGAGATCTACACTCGTGGAATCGTCGGCAGCGTC
F185-ACACAACA	AATGATACGGCGACCACCGAGATCTACACACACAACATCGTCGGCAGCGTC
F186-TAGCTCGT	AATGATACGGCGACCACCGAGATCTACACTAGCTCGTTCGTCGGCAGCGTC
F187-TCGTAGTG	AATGATACGGCGACCACCGAGATCTACACTCGTAGTGTCGTCGGCAGCGTC
F188-GAAGCTTC	AATGATACGGCGACCACCGAGATCTACACGAAGCTTCTCGTCGGCAGCGTC
F189-AGTGAGGT	AATGATACGGCGACCACCGAGATCTACACAGTGAGGTTCGTCGGCAGCGTC
F190-GCTAGTAC	AATGATACGGCGACCACCGAGATCTACACGCTAGTACTCGTCGGCAGCGTC
F191-GAACCAAC	AATGATACGGCGACCACCGAGATCTACACGAACCAACTCGTCGGCAGCGTC
F192-CTCTCTAG	AATGATACGGCGACCACCGAGATCTACACCTCTCTAGTCGTCGGCAGCGTC
