F001-CAACCATG	AATGATACGGCGACCACCGAGATCTACACCAACCATGTCGTCGGCAGCGTC
F002-AACCAGAG	AATGATACGGCGACCACCGAGATCTACACAACCAGAGTCGTCGGCAGCGTC
F003-ATGGTACC	AATGATACGGCGACCACCGAGATCTACACATGGTACCTCGTCGGCAGCGTC
F004-GTTCATCT	AATGATACGGCGACCACCGAGATCTACACGTTCATCTTCGTCGGCAGCGTC
F005-TACCATGC	AATGATACGGCGACCACCGAGATCTACACTACCATGCTCGTCGGCAGCGTC
F006-AAGTGCTA	AATGATACGGCGACCACCGAGATCTACACAAGTGCTATCGTCGGCAGCGTC
F007-GTACTGAC	AATGATACGGCGACCACCGAGATCTACACGTACTGACTCGTCGGCAGCGTC
F008-TAGGATGG	AATGATACGGCGACCACCGAGATCTACACTAGGATGGTCGTCGGCAGCGTC
F009-ACTGTCGT	AATGATACGGCGACCACCGAGATCTACACACTGTCGTTCGTCGGCAGCGTC
F010-GGTTGAGA	AATGATACGGCGACCACCGAGATCTACACGGTTGAGATCGTCGGCAGCGTC
F011-CTAGTTCG	AATGATACGGCGACCACCGAGATCTACACCTAGTTCGTCGTCGGCAGCGTC
F012-TTCACCAC	AATGATACGGCGACCACCGAGATCTACACTTCACCACTCGTCGGCAGCGTC
F013-GAACGTAG	AATGATACGGCGACCACCGAGATCTACACGAACGTAGTCGTCGGCAGCGTC
F014-CGATGTAG	AATGATACGGCGACCACCGAGATCTACACCGATGTAGTCGTCGGCAGCGTC
F015-TGTTGCTG	AATGATACGGCGACCACCGAGATCTACACTGTTGCTGTCGTCGGCAGCGTC
F016-TCATGTGG	AATGATACGGCGACCACCGAGATCTACACTCATGTGGTCGTCGGCAGCGTC
F017-AACAAGCA	AATGATACGGCGACCACCGAGATCTACACAACAAGCATCGTCGGCAGCGTC
F018-GATCTCAG	AATGATACGGCGACCACCGAGATCTACACGATCTCAGTCGTCGGCAGCGTC
F019-CTTCACAT	AATGATACGGCGACCACCGAGATCTACACCTTCACATTCGTCGGCAGCGTC
F020-AGTACCAC	AATGATACGGCGACCACCGAGATCTACACAGTACCACTCGTCGGCAGCGTC
F021-ATGGAAGA	AATGATACGGCGACCACCGAGATCTACACATGGAAGATCGTCGGCAGCGTC
F022-TTCTCCTA	AATGATACGGCGACCACCGAGATCTACACTTCTCCTATCGTCGGCAGCGTC
F023-TCCAGGTA	AATGATACGGCGACCACCGAGATCTACACTCCAGGTATCGTCGGCAGCGTC
F024-AAGGAGTA	AATGATACGGCGACCACCGAGATCTACACAAGGAGTATCGTCGGCAGCGTC
F025-ACGATGAC	AATGATACGGCGACCACCGAGATCTACACACGATGACTCGTCGGCAGCGTC
F026-AGTCCAGT	AATGATACGGCGACCACCGAGATCTACACAGTCCAGTTCGTCGGCAGCGTC
F027-GTAGAGGT	AATGATACGGCGACCACCGAGATCTACACGTAGAGGTTCGTCGGCAGCGTC
F028-ATCTGTTC	AATGATACGGCGACCACCGAGATCTACACATCTGTTCTCGTCGGCAGCGTC
F029-AAGAGTCG	AATGATACGGCGACCACCGAGATCTACACAAGAGTCGTCGTCGGCAGCGTC
F030-CAAGACCA	AATGATACGGCGACCACCGAGATCTACACCAAGACCATCGTCGGCAGCGTC
F031-TCGTACAC	AATGATACGGCGACCACCGAGATCTACACTCGTACACTCGTCGGCAGCGTC
F032-GCACTTGT	AATGATACGGCGACCACCGAGATCTACACGCACTTGTTCGTCGGCAGCGTC
F033-AGGAGATG	AATGATACGGCGACCACCGAGATCTACACAGGAGATGTCGTCGGCAGCGTC
F034-TGAACACC	AATGATACGGCGACCACCGAGATCTACACTGAACACCTCGTCGGCAGCGTC
F035-TGAGAAGG	AATGATACGGCGACCACCGAGATCTACACTGAGAAGGTCGTCGGCAGCGTC
F036-GATGGTCA	AATGATACGGCGACCACCGAGATCTACACGATGGTCATCGTCGGCAGCGTC
F037-CCTGATGA	AATGATACGGCGACCACCGAGATCTACACCCTGATGATCGTCGGCAGCGTC
F038-AGAGTAGT	AATGATACGGCGACCACCGAGATCTACACAGAGTAGTTCGTCGGCAGCGTC
F039-GAAGACAC	AATGATACGGCGACCACCGAGATCTACACGAAGACACTCGTCGGCAGCGTC
F040-AAGCTTGC	AATGATACGGCGACCACCGAGATCTACACAAGCTTGCTCGTCGGCAGCGTC
F041-CTACTAGT	AATGATACGGCGACCACCGAGATCTACACCTACTAGTTCGTCGGCAGCGTC
F042-TCGTGGAA	AATGATACGGCGACCACCGAGATCTACACTCGTGGAATCGTCGGCAGCGTC
F043-CTCTCTAG	AATGATACGGCGACCACCGAGATCTACACCTCTCTAGTCGTCGGCAGCGTC
F044-GTCAAGCT	AATGATACGGCGACCACCGAGATCTACACGTCAAGCTTCGTCGGCAGCGTC
F045-GTGATCTT	AATGATACGGCGACCACCGAGATCTACACGTGATCTTTCGTCGGCAGCGTC
F046-TGTTGGAC	AATGATACGGCGACCACCGAGATCTACACTGTTGGACTCGTCGGCAGCGTC
F047-AACACCTA	AATGATACGGCGACCACCGAGATCTACACAACACCTATCGTCGGCAGCGTC
F048-TAGAACCT	AATGATACGGCGACCACCGAGATCTACACTAGAACCTTCGTCGGCAGCGTC
F049-TTGAAGAG	AATGATACGGCGACCACCGAGATCTACACTTGAAGAGTCGTCGGCAGCGTC
F050-CTGTGTAC	AATGATACGGCGACCACCGAGATCTACACCTGTGTACTCGTCGGCAGCGTC
F051-ACTGGAAC	AATGATACGGCGACCACCGAGATCTACACACTGGAACTCGTCGGCAGCGTC
F052-GTCAGTCA	AATGATACGGCGACCACCGAGATCTACACGTCAGTCATCGTCGGCAGCGTC
F053-ATGAACTC	AATGATACGGCGACCACCGAGATCTACACATGAACTCTCGTCGGCAGCGTC
F054-ACAGCTGT	AATGATACGGCGACCACCGAGATCTACACACAGCTGTTCGTCGGCAGCGTC
F055-GAACAACG	AATGATACGGCGACCACCGAGATCTACACGAACAACGTCGTCGGCAGCGTC
F056-AGCATCTG	AATGATACGGCGACCACCGAGATCTACACAGCATCTGTCGTCGGCAGCGTC
F057-GATGTGCT	AATGATACGGCGACCACCGAGATCTACACGATGTGCTTCGTCGGCAGCGTC
F058-AGAGTCTA	AATGATACGGCGACCACCGAGATCTACACAGAGTCTATCGTCGGCAGCGTC
F059-TACTCTGT	AATGATACGGCGACCACCGAGATCTACACTACTCTGTTCGTCGGCAGCGTC
F060-GAGAACGA	AATGATACGGCGACCACCGAGATCTACACGAGAACGATCGTCGGCAGCGTC
F061-TCTTGACC	AATGATACGGCGACCACCGAGATCTACACTCTTGACCTCGTCGGCAGCGTC
F062-TAGTCGTA	AATGATACGGCGACCACCGAGATCTACACTAGTCGTATCGTCGGCAGCGTC
F063-TTGTGAAG	AATGATACGGCGACCACCGAGATCTACACTTGTGAAGTCGTCGGCAGCGTC
F064-GTCTTCCA	AATGATACGGCGACCACCGAGATCTACACGTCTTCCATCGTCGGCAGCGTC
F065-CAACACTC	AATGATACGGCGACCACCGAGATCTACACCAACACTCTCGTCGGCAGCGTC
F066-GAAGATCT	AATGATACGGCGACCACCGAGATCTACACGAAGATCTTCGTCGGCAGCGTC
F067-AGTGCTAG	AATGATACGGCGACCACCGAGATCTACACAGTGCTAGTCGTCGGCAGCGTC
F068-AGTCGTTG	AATGATACGGCGACCACCGAGATCTACACAGTCGTTGTCGTCGGCAGCGTC
F069-AGAACAGA	AATGATACGGCGACCACCGAGATCTACACAGAACAGATCGTCGGCAGCGTC
F070-ATGCTCTG	AATGATACGGCGACCACCGAGATCTACACATGCTCTGTCGTCGGCAGCGTC
F071-ACACAGGT	AATGATACGGCGACCACCGAGATCTACACACACAGGTTCGTCGGCAGCGTC
F072-TCACGTAC	AATGATACGGCGACCACCGAGATCTACACTCACGTACTCGTCGGCAGCGTC
F073-CGAGACTT	AATGATACGGCGACCACCGAGATCTACACCGAGACTTTCGTCGGCAGCGTC
F074-ACGTACGT	AATGATACGGCGACCACCGAGATCTACACACGTACGTTCGTCGGCAGCGTC
F075-GTGACAAC	AATGATACGGCGACCACCGAGATCTACACGTGACAACTCGTCGGCAGCGTC
F076-CTACGTCA	AATGATACGGCGACCACCGAGATCTACACCTACGTCATCGTCGGCAGCGTC
F077-GAACAGAA	AATGATACGGCGACCACCGAGATCTACACGAACAGAATCGTCGGCAGCGTC
F078-ACAGTCAG	AATGATACGGCGACCACCGAGATCTACACACAGTCAGTCGTCGGCAGCGTC
F079-GTAGGAAG	AATGATACGGCGACCACCGAGATCTACACGTAGGAAGTCGTCGGCAGCGTC
F080-TCTCTGTC	AATGATACGGCGACCACCGAGATCTACACTCTCTGTCTCGTCGGCAGCGTC
F081-GCTTCTCA	AATGATACGGCGACCACCGAGATCTACACGCTTCTCATCGTCGGCAGCGTC
F082-CTGATGTG	AATGATACGGCGACCACCGAGATCTACACCTGATGTGTCGTCGGCAGCGTC
F083-GTTCTCGA	AATGATACGGCGACCACCGAGATCTACACGTTCTCGATCGTCGGCAGCGTC
F084-AACTCTTG	AATGATACGGCGACCACCGAGATCTACACAACTCTTGTCGTCGGCAGCGTC
F085-GAACCAAC	AATGATACGGCGACCACCGAGATCTACACGAACCAACTCGTCGGCAGCGTC
F086-GAAGAGTG	AATGATACGGCGACCACCGAGATCTACACGAAGAGTGTCGTCGGCAGCGTC
F087-TTCTTGAC	AATGATACGGCGACCACCGAGATCTACACTTCTTGACTCGTCGGCAGCGTC
F088-CTTGCATC	AATGATACGGCGACCACCGAGATCTACACCTTGCATCTCGTCGGCAGCGTC
F089-TAGCTCGT	AATGATACGGCGACCACCGAGATCTACACTAGCTCGTTCGTCGGCAGCGTC
F090-AACCACGA	AATGATACGGCGACCACCGAGATCTACACAACCACGATCGTCGGCAGCGTC
F091-AGTACACG	AATGATACGGCGACCACCGAGATCTACACAGTACACGTCGTCGGCAGCGTC
F092-CTTGTGAG	AATGATACGGCGACCACCGAGATCTACACCTTGTGAGTCGTCGGCAGCGTC
F093-CTAGGTTC	AATGATACGGCGACCACCGAGATCTACACCTAGGTTCTCGTCGGCAGCGTC
F094-TCTTCGAG	AATGATACGGCGACCACCGAGATCTACACTCTTCGAGTCGTCGGCAGCGTC
F095-TCCAGTCT	AATGATACGGCGACCACCGAGATCTACACTCCAGTCTTCGTCGGCAGCGTC
F096-CTTCTCTC	AATGATACGGCGACCACCGAGATCTACACCTTCTCTCTCGTCGGCAGCGTC
F097-GTCTAGAG	AATGATACGGCGACCACCGAGATCTACACGTCTAGAGTCGTCGGCAGCGTC
F098-TTGGTAGG	AATGATACGGCGACCACCGAGATCTACACTTGGTAGGTCGTCGGCAGCGTC
F099-AACTCAGA	AATGATACGGCGACCACCGAGATCTACACAACTCAGATCGTCGGCAGCGTC
F100-CATCGAAG	AATGATACGGCGACCACCGAGATCTACACCATCGAAGTCGTCGGCAGCGTC
F101-AGGACTGT	AATGATACGGCGACCACCGAGATCTACACAGGACTGTTCGTCGGCAGCGTC
F102-TTCAGACC	AATGATACGGCGACCACCGAGATCTACACTTCAGACCTCGTCGGCAGCGTC
F103-ACAAGACG	AATGATACGGCGACCACCGAGATCTACACACAAGACGTCGTCGGCAGCGTC
F104-TGGACGAA	AATGATACGGCGACCACCGAGATCTACACTGGACGAATCGTCGGCAGCGTC
F105-GAAGTTGA	AATGATACGGCGACCACCGAGATCTACACGAAGTTGATCGTCGGCAGCGTC
F106-AAGAAGGT	AATGATACGGCGACCACCGAGATCTACACAAGAAGGTTCGTCGGCAGCGTC
F107-TCATGCTA	AATGATACGGCGACCACCGAGATCTACACTCATGCTATCGTCGGCAGCGTC
F108-AGTTCTCC	AATGATACGGCGACCACCGAGATCTACACAGTTCTCCTCGTCGGCAGCGTC
F109-GAACCTCA	AATGATACGGCGACCACCGAGATCTACACGAACCTCATCGTCGGCAGCGTC
F110-ATCTAGGT	AATGATACGGCGACCACCGAGATCTACACATCTAGGTTCGTCGGCAGCGTC
F111-ACATCACT	AATGATACGGCGACCACCGAGATCTACACACATCACTTCGTCGGCAGCGTC
F112-GATCAGTC	AATGATACGGCGACCACCGAGATCTACACGATCAGTCTCGTCGGCAGCGTC
F113-ATGTGACA	AATGATACGGCGACCACCGAGATCTACACATGTGACATCGTCGGCAGCGTC
F114-CACTTGGT	AATGATACGGCGACCACCGAGATCTACACCACTTGGTTCGTCGGCAGCGTC
F115-GTCACAGA	AATGATACGGCGACCACCGAGATCTACACGTCACAGATCGTCGGCAGCGTC
F116-AAGTCATC	AATGATACGGCGACCACCGAGATCTACACAAGTCATCTCGTCGGCAGCGTC
F117-TGTCGTCT	AATGATACGGCGACCACCGAGATCTACACTGTCGTCTTCGTCGGCAGCGTC
F118-AAGCTCAA	AATGATACGGCGACCACCGAGATCTACACAAGCTCAATCGTCGGCAGCGTC
F119-TTCGTCAG	AATGATACGGCGACCACCGAGATCTACACTTCGTCAGTCGTCGGCAGCGTC
F120-GTGAGTTG	AATGATACGGCGACCACCGAGATCTACACGTGAGTTGTCGTCGGCAGCGTC
F121-TACATGAG	AATGATACGGCGACCACCGAGATCTACACTACATGAGTCGTCGGCAGCGTC
F122-TCACCTGA	AATGATACGGCGACCACCGAGATCTACACTCACCTGATCGTCGGCAGCGTC
F123-GATCATGG	AATGATACGGCGACCACCGAGATCTACACGATCATGGTCGTCGGCAGCGTC
F124-AGGAACCA	AATGATACGGCGACCACCGAGATCTACACAGGAACCATCGTCGGCAGCGTC
F125-TTGAGGTT	AATGATACGGCGACCACCGAGATCTACACTTGAGGTTTCGTCGGCAGCGTC
F126-AGCTCCTT	AATGATACGGCGACCACCGAGATCTACACAGCTCCTTTCGTCGGCAGCGTC
F127-AGTGACAA	AATGATACGGCGACCACCGAGATCTACACAGTGACAATCGTCGGCAGCGTC
F128-ACCTGTCA	AATGATACGGCGACCACCGAGATCTACACACCTGTCATCGTCGGCAGCGTC
F129-AACTGAAC	AATGATACGGCGACCACCGAGATCTACACAACTGAACTCGTCGGCAGCGTC
F130-GGTTCGAA	AATGATACGGCGACCACCGAGATCTACACGGTTCGAATCGTCGGCAGCGTC
F131-GGAAGAGT	AATGATACGGCGACCACCGAGATCTACACGGAAGAGTTCGTCGGCAGCGTC
F132-CAGTGATG	AATGATACGGCGACCACCGAGATCTACACCAGTGATGTCGTCGGCAGCGTC
F133-AACACTCC	AATGATACGGCGACCACCGAGATCTACACAACACTCCTCGTCGGCAGCGTC
F134-ACACGTCT	AATGATACGGCGACCACCGAGATCTACACACACGTCTTCGTCGGCAGCGTC
F135-CAGTGGAT	AATGATACGGCGACCACCGAGATCTACACCAGTGGATTCGTCGGCAGCGTC
F136-AGGATGCT	AATGATACGGCGACCACCGAGATCTACACAGGATGCTTCGTCGGCAGCGTC
F137-TGAGGATC	AATGATACGGCGACCACCGAGATCTACACTGAGGATCTCGTCGGCAGCGTC
F138-ATGATCGA	AATGATACGGCGACCACCGAGATCTACACATGATCGATCGTCGGCAGCGTC
F139-TAGTCCAG	AATGATACGGCGACCACCGAGATCTACACTAGTCCAGTCGTCGGCAGCGTC
F140-AGAGCATG	AATGATACGGCGACCACCGAGATCTACACAGAGCATGTCGTCGGCAGCGTC
F141-GCAGTGTA	AATGATACGGCGACCACCGAGATCTACACGCAGTGTATCGTCGGCAGCGTC
F142-GGAACTAC	AATGATACGGCGACCACCGAGATCTACACGGAACTACTCGTCGGCAGCGTC
F143-TGTCAAGC	AATGATACGGCGACCACCGAGATCTACACTGTCAAGCTCGTCGGCAGCGTC
F144-TCTGAAGT	AATGATACGGCGACCACCGAGATCTACACTCTGAAGTTCGTCGGCAGCGTC
F145-CACTGTCT	AATGATACGGCGACCACCGAGATCTACACCACTGTCTTCGTCGGCAGCGTC
F146-TTGGTCCA	AATGATACGGCGACCACCGAGATCTACACTTGGTCCATCGTCGGCAGCGTC
F147-GGACAGTT	AATGATACGGCGACCACCGAGATCTACACGGACAGTTTCGTCGGCAGCGTC
F148-AGTGAGGT	AATGATACGGCGACCACCGAGATCTACACAGTGAGGTTCGTCGGCAGCGTC
F149-TCGAACTA	AATGATACGGCGACCACCGAGATCTACACTCGAACTATCGTCGGCAGCGTC
F150-ACTCATCC	AATGATACGGCGACCACCGAGATCTACACACTCATCCTCGTCGGCAGCGTC
F151-CAAGTGTC	AATGATACGGCGACCACCGAGATCTACACCAAGTGTCTCGTCGGCAGCGTC
F152-ACTACTGG	AATGATACGGCGACCACCGAGATCTACACACTACTGGTCGTCGGCAGCGTC
F153-CGATCAGT	AATGATACGGCGACCACCGAGATCTACACCGATCAGTTCGTCGGCAGCGTC
F154-TGAGTCCT	AATGATACGGCGACCACCGAGATCTACACTGAGTCCTTCGTCGGCAGCGTC
F155-TACCTCCA	AATGATACGGCGACCACCGAGATCTACACTACCTCCATCGTCGGCAGCGTC
F156-TGTCTCAC	AATGATACGGCGACCACCGAGATCTACACTGTCTCACTCGTCGGCAGCGTC
F157-AGAGGTAC	AATGATACGGCGACCACCGAGATCTACACAGAGGTACTCGTCGGCAGCGTC
F158-TCTCGATG	AATGATACGGCGACCACCGAGATCTACACTCTCGATGTCGTCGGCAGCGTC
F159-CTGTTCAG	AATGATACGGCGACCACCGAGATCTACACCTGTTCAGTCGTCGGCAGCGTC
F160-AGCAAGAT	AATGATACGGCGACCACCGAGATCTACACAGCAAGATTCGTCGGCAGCGTC
F161-TGTGATCA	AATGATACGGCGACCACCGAGATCTACACTGTGATCATCGTCGGCAGCGTC
F162-GAGCTGTT	AATGATACGGCGACCACCGAGATCTACACGAGCTGTTTCGTCGGCAGCGTC
F163-CAAGATGC	AATGATACGGCGACCACCGAGATCTACACCAAGATGCTCGTCGGCAGCGTC
F164-TCTCACAG	AATGATACGGCGACCACCGAGATCTACACTCTCACAGTCGTCGGCAGCGTC
F165-TCAGTACG	AATGATACGGCGACCACCGAGATCTACACTCAGTACGTCGTCGGCAGCGTC
F166-GTACAAGC	AATGATACGGCGACCACCGAGATCTACACGTACAAGCTCGTCGGCAGCGTC
F167-ATCCTGTA	AATGATACGGCGACCACCGAGATCTACACATCCTGTATCGTCGGCAGCGTC
F168-ACTTCAGC	AATGATACGGCGACCACCGAGATCTACACACTTCAGCTCGTCGGCAGCGTC
F169-CTGGACTA	AATGATACGGCGACCACCGAGATCTACACCTGGACTATCGTCGGCAGCGTC
F170-TCAGGTCA	AATGATACGGCGACCACCGAGATCTACACTCAGGTCATCGTCGGCAGCGTC
F171-CGTACTTG	AATGATACGGCGACCACCGAGATCTACACCGTACTTGTCGTCGGCAGCGTC
F172-TAGAAGTC	AATGATACGGCGACCACCGAGATCTACACTAGAAGTCTCGTCGGCAGCGTC
F173-GTGTGATC	AATGATACGGCGACCACCGAGATCTACACGTGTGATCTCGTCGGCAGCGTC
F174-TTGCAGGT	AATGATACGGCGACCACCGAGATCTACACTTGCAGGTTCGTCGGCAGCGTC
F175-ACCTACAA	AATGATACGGCGACCACCGAGATCTACACACCTACAATCGTCGGCAGCGTC
F176-CAAGTCAT	AATGATACGGCGACCACCGAGATCTACACCAAGTCATTCGTCGGCAGCGTC
F177-TACTGTAG	AATGATACGGCGACCACCGAGATCTACACTACTGTAGTCGTCGGCAGCGTC
F178-TTCATCCT	AATGATACGGCGACCACCGAGATCTACACTTCATCCTTCGTCGGCAGCGTC
F179-ATGCAACT	AATGATACGGCGACCACCGAGATCTACACATGCAACTTCGTCGGCAGCGTC
F180-AACAGTGA	AATGATACGGCGACCACCGAGATCTACACAACAGTGATCGTCGGCAGCGTC
F181-CACTAGTG	AATGATACGGCGACCACCGAGATCTACACCACTAGTGTCGTCGGCAGCGTC
F182-ACTGCACA	AATGATACGGCGACCACCGAGATCTACACACTGCACATCGTCGGCAGCGTC
F183-GTTCTGTG	AATGATACGGCGACCACCGAGATCTACACGTTCTGTGTCGTCGGCAGCGTC
F184-ACAAGGTT	AATGATACGGCGACCACCGAGATCTACACACAAGGTTTCGTCGGCAGCGTC
F185-AACTACCT	AATGATACGGCGACCACCGAGATCTACACAACTACCTTCGTCGGCAGCGTC
F186-TGTGACTC	AATGATACGGCGACCACCGAGATCTACACTGTGACTCTCGTCGGCAGCGTC
F187-TTGCTTGA	AATGATACGGCGACCACCGAGATCTACACTTGCTTGATCGTCGGCAGCGTC
F188-TTCCAACA	AATGATACGGCGACCACCGAGATCTACACTTCCAACATCGTCGGCAGCGTC
F189-GATGCAAG	AATGATACGGCGACCACCGAGATCTACACGATGCAAGTCGTCGGCAGCGTC
F190-AGACTCAT	AATGATACGGCGACCACCGAGATCTACACAGACTCATTCGTCGGCAGCGTC
F191-TGTAGTTC	AATGATACGGCGACCACCGAGATCTACACTGTAGTTCTCGTCGGCAGCGTC
F192-ACAGTTCC	AATGATACGGCGACCACCGAGATCTACACACAGTTCCTCGTCGGCAGCGTC
F193-AGAGATCG	AATGATACGGCGACCACCGAGATCTACACAGAGATCGTCGTCGGCAGCGTC
F194-TTGGTGTC	AATGATACGGCGACCACCGAGATCTACACTTGGTGTCTCGTCGGCAGCGTC
F195-GGAAGGAA	AATGATACGGCGACCACCGAGATCTACACGGAAGGAATCGTCGGCAGCGTC
F196-TCCTGCAT	AATGATACGGCGACCACCGAGATCTACACTCCTGCATTCGTCGGCAGCGTC
F197-TCCACTTG	AATGATACGGCGACCACCGAGATCTACACTCCACTTGTCGTCGGCAGCGTC
F198-GATGAAGA	AATGATACGGCGACCACCGAGATCTACACGATGAAGATCGTCGGCAGCGTC
F199-TAGGTGAT	AATGATACGGCGACCACCGAGATCTACACTAGGTGATTCGTCGGCAGCGTC
F200-ACTCGTGA	AATGATACGGCGACCACCGAGATCTACACACTCGTGATCGTCGGCAGCGTC
F201-CTCACATG	AATGATACGGCGACCACCGAGATCTACACCTCACATGTCGTCGGCAGCGTC
F202-ACACGATC	AATGATACGGCGACCACCGAGATCTACACACACGATCTCGTCGGCAGCGTC
F203-CTTCAACC	AATGATACGGCGACCACCGAGATCTACACCTTCAACCTCGTCGGCAGCGTC
F204-CTGTACCT	AATGATACGGCGACCACCGAGATCTACACCTGTACCTTCGTCGGCAGCGTC
F205-ACATGGAC	AATGATACGGCGACCACCGAGATCTACACACATGGACTCGTCGGCAGCGTC
F206-TCTCAGCT	AATGATACGGCGACCACCGAGATCTACACTCTCAGCTTCGTCGGCAGCGTC
F207-AGAGAGTC	AATGATACGGCGACCACCGAGATCTACACAGAGAGTCTCGTCGGCAGCGTC
F208-AGTCTGTT	AATGATACGGCGACCACCGAGATCTACACAGTCTGTTTCGTCGGCAGCGTC
F209-TTGACACG	AATGATACGGCGACCACCGAGATCTACACTTGACACGTCGTCGGCAGCGTC
F210-AGATCCAA	AATGATACGGCGACCACCGAGATCTACACAGATCCAATCGTCGGCAGCGTC
F211-CTAGGAGA	AATGATACGGCGACCACCGAGATCTACACCTAGGAGATCGTCGGCAGCGTC
F212-GACATGTA	AATGATACGGCGACCACCGAGATCTACACGACATGTATCGTCGGCAGCGTC
F213-CAGACAGT	AATGATACGGCGACCACCGAGATCTACACCAGACAGTTCGTCGGCAGCGTC
F214-GCTTGTGT	AATGATACGGCGACCACCGAGATCTACACGCTTGTGTTCGTCGGCAGCGTC
F215-TAGTGACT	AATGATACGGCGACCACCGAGATCTACACTAGTGACTTCGTCGGCAGCGTC
F216-GTCAACAA	AATGATACGGCGACCACCGAGATCTACACGTCAACAATCGTCGGCAGCGTC
F217-GAACACGT	AATGATACGGCGACCACCGAGATCTACACGAACACGTTCGTCGGCAGCGTC
F218-ACCACGAA	AATGATACGGCGACCACCGAGATCTACACACCACGAATCGTCGGCAGCGTC
F219-GGATCACA	AATGATACGGCGACCACCGAGATCTACACGGATCACATCGTCGGCAGCGTC
F220-GCTTGAAG	AATGATACGGCGACCACCGAGATCTACACGCTTGAAGTCGTCGGCAGCGTC
F221-AGTACGTA	AATGATACGGCGACCACCGAGATCTACACAGTACGTATCGTCGGCAGCGTC
F222-CATGGTTG	AATGATACGGCGACCACCGAGATCTACACCATGGTTGTCGTCGGCAGCGTC
F223-CTGCTGAT	AATGATACGGCGACCACCGAGATCTACACCTGCTGATTCGTCGGCAGCGTC
F224-TCTTGGTT	AATGATACGGCGACCACCGAGATCTACACTCTTGGTTTCGTCGGCAGCGTC
F225-AGATGCTC	AATGATACGGCGACCACCGAGATCTACACAGATGCTCTCGTCGGCAGCGTC
F226-ACACAACA	AATGATACGGCGACCACCGAGATCTACACACACAACATCGTCGGCAGCGTC
F227-GTAGTCTG	AATGATACGGCGACCACCGAGATCTACACGTAGTCTGTCGTCGGCAGCGTC
F228-TTGCATCC	AATGATACGGCGACCACCGAGATCTACACTTGCATCCTCGTCGGCAGCGTC
F229-CATCAAGT	AATGATACGGCGACCACCGAGATCTACACCATCAAGTTCGTCGGCAGCGTC
F230-CTTGAGCA	AATGATACGGCGACCACCGAGATCTACACCTTGAGCATCGTCGGCAGCGTC
F231-CATCCTTC	AATGATACGGCGACCACCGAGATCTACACCATCCTTCTCGTCGGCAGCGTC
F232-CTGTAGTC	AATGATACGGCGACCACCGAGATCTACACCTGTAGTCTCGTCGGCAGCGTC
F233-TACAGCAA	AATGATACGGCGACCACCGAGATCTACACTACAGCAATCGTCGGCAGCGTC
F234-GTGTTGCT	AATGATACGGCGACCACCGAGATCTACACGTGTTGCTTCGTCGGCAGCGTC
F235-GCATCATG	AATGATACGGCGACCACCGAGATCTACACGCATCATGTCGTCGGCAGCGTC
F236-TGCAGCTT	AATGATACGGCGACCACCGAGATCTACACTGCAGCTTTCGTCGGCAGCGTC
F237-AAGAGAGC	AATGATACGGCGACCACCGAGATCTACACAAGAGAGCTCGTCGGCAGCGTC
F238-TGAAGTCG	AATGATACGGCGACCACCGAGATCTACACTGAAGTCGTCGTCGGCAGCGTC
F239-CAAGCTAG	AATGATACGGCGACCACCGAGATCTACACCAAGCTAGTCGTCGGCAGCGTC
F240-TGCTTCAA	AATGATACGGCGACCACCGAGATCTACACTGCTTCAATCGTCGGCAGCGTC
F241-CGTTCAAC	AATGATACGGCGACCACCGAGATCTACACCGTTCAACTCGTCGGCAGCGTC
F242-AGCTGAGT	AATGATACGGCGACCACCGAGATCTACACAGCTGAGTTCGTCGGCAGCGTC
F243-GAGTGTGA	AATGATACGGCGACCACCGAGATCTACACGAGTGTGATCGTCGGCAGCGTC
F244-CAGAGCTT	AATGATACGGCGACCACCGAGATCTACACCAGAGCTTTCGTCGGCAGCGTC
F245-ATGACTAG	AATGATACGGCGACCACCGAGATCTACACATGACTAGTCGTCGGCAGCGTC
F246-TGCTTGCT	AATGATACGGCGACCACCGAGATCTACACTGCTTGCTTCGTCGGCAGCGTC
F247-AAGACGTG	AATGATACGGCGACCACCGAGATCTACACAAGACGTGTCGTCGGCAGCGTC
F248-TGCAAGGA	AATGATACGGCGACCACCGAGATCTACACTGCAAGGATCGTCGGCAGCGTC
F249-TCAACCAT	AATGATACGGCGACCACCGAGATCTACACTCAACCATTCGTCGGCAGCGTC
F250-CAACTACA	AATGATACGGCGACCACCGAGATCTACACCAACTACATCGTCGGCAGCGTC
F251-TCAGACGA	AATGATACGGCGACCACCGAGATCTACACTCAGACGATCGTCGGCAGCGTC
F252-GTGGTGAA	AATGATACGGCGACCACCGAGATCTACACGTGGTGAATCGTCGGCAGCGTC
F253-CATGTCGA	AATGATACGGCGACCACCGAGATCTACACCATGTCGATCGTCGGCAGCGTC
F254-TTGTCTGC	AATGATACGGCGACCACCGAGATCTACACTTGTCTGCTCGTCGGCAGCGTC
F255-CTCACGAT	AATGATACGGCGACCACCGAGATCTACACCTCACGATTCGTCGGCAGCGTC
F256-GTCGTACT	AATGATACGGCGACCACCGAGATCTACACGTCGTACTTCGTCGGCAGCGTC
F257-AAGACACA	AATGATACGGCGACCACCGAGATCTACACAAGACACATCGTCGGCAGCGTC
F258-TCTAGAGA	AATGATACGGCGACCACCGAGATCTACACTCTAGAGATCGTCGGCAGCGTC
F259-CAACTGAG	AATGATACGGCGACCACCGAGATCTACACCAACTGAGTCGTCGGCAGCGTC
F260-TGATCGTT	AATGATACGGCGACCACCGAGATCTACACTGATCGTTTCGTCGGCAGCGTC
F261-AACGAAGT	AATGATACGGCGACCACCGAGATCTACACAACGAAGTTCGTCGGCAGCGTC
F262-TAGAGTGT	AATGATACGGCGACCACCGAGATCTACACTAGAGTGTTCGTCGGCAGCGTC
F263-GTGCTACA	AATGATACGGCGACCACCGAGATCTACACGTGCTACATCGTCGGCAGCGTC
F264-CTAGAGAC	AATGATACGGCGACCACCGAGATCTACACCTAGAGACTCGTCGGCAGCGTC
F265-AAGAGGAA	AATGATACGGCGACCACCGAGATCTACACAAGAGGAATCGTCGGCAGCGTC
F266-TCTCCAAC	AATGATACGGCGACCACCGAGATCTACACTCTCCAACTCGTCGGCAGCGTC
F267-GGTACCTT	AATGATACGGCGACCACCGAGATCTACACGGTACCTTTCGTCGGCAGCGTC
F268-CGAAGTGA	AATGATACGGCGACCACCGAGATCTACACCGAAGTGATCGTCGGCAGCGTC
F269-TCGTAGTG	AATGATACGGCGACCACCGAGATCTACACTCGTAGTGTCGTCGGCAGCGTC
F270-TCAGTCTC	AATGATACGGCGACCACCGAGATCTACACTCAGTCTCTCGTCGGCAGCGTC
F271-CTCGATCT	AATGATACGGCGACCACCGAGATCTACACCTCGATCTTCGTCGGCAGCGTC
F272-TGAGGTGT	AATGATACGGCGACCACCGAGATCTACACTGAGGTGTTCGTCGGCAGCGTC
F273-ATCAGCAT	AATGATACGGCGACCACCGAGATCTACACATCAGCATTCGTCGGCAGCGTC
F274-ACCTCTAC	AATGATACGGCGACCACCGAGATCTACACACCTCTACTCGTCGGCAGCGTC
F275-GAGATCAC	AATGATACGGCGACCACCGAGATCTACACGAGATCACTCGTCGGCAGCGTC
F276-CTTGAAGG	AATGATACGGCGACCACCGAGATCTACACCTTGAAGGTCGTCGGCAGCGTC
F277-AACAGGTC	AATGATACGGCGACCACCGAGATCTACACAACAGGTCTCGTCGGCAGCGTC
F278-AGGTTGAG	AATGATACGGCGACCACCGAGATCTACACAGGTTGAGTCGTCGGCAGCGTC
F279-GATGGATC	AATGATACGGCGACCACCGAGATCTACACGATGGATCTCGTCGGCAGCGTC
F280-GTACCTTG	AATGATACGGCGACCACCGAGATCTACACGTACCTTGTCGTCGGCAGCGTC
F281-ATCGTCTT	AATGATACGGCGACCACCGAGATCTACACATCGTCTTTCGTCGGCAGCGTC
F282-TGACAACT	AATGATACGGCGACCACCGAGATCTACACTGACAACTTCGTCGGCAGCGTC
F283-GTTCCTAC	AATGATACGGCGACCACCGAGATCTACACGTTCCTACTCGTCGGCAGCGTC
F284-TTGTCGAT	AATGATACGGCGACCACCGAGATCTACACTTGTCGATTCGTCGGCAGCGTC
F285-CAAGTAGG	AATGATACGGCGACCACCGAGATCTACACCAAGTAGGTCGTCGGCAGCGTC
F286-TCGTTCGA	AATGATACGGCGACCACCGAGATCTACACTCGTTCGATCGTCGGCAGCGTC
F287-AAGCATCA	AATGATACGGCGACCACCGAGATCTACACAAGCATCATCGTCGGCAGCGTC
F288-AACCAACC	AATGATACGGCGACCACCGAGATCTACACAACCAACCTCGTCGGCAGCGTC
F289-TAGATCTG	AATGATACGGCGACCACCGAGATCTACACTAGATCTGTCGTCGGCAGCGTC
F290-GTTGCTGA	AATGATACGGCGACCACCGAGATCTACACGTTGCTGATCGTCGGCAGCGTC
F291-ACTCTACT	AATGATACGGCGACCACCGAGATCTACACACTCTACTTCGTCGGCAGCGTC
F292-ATGGTGGT	AATGATACGGCGACCACCGAGATCTACACATGGTGGTTCGTCGGCAGCGTC
F293-CAAGGAAC	AATGATACGGCGACCACCGAGATCTACACCAAGGAACTCGTCGGCAGCGTC
F294-TGACACAA	AATGATACGGCGACCACCGAGATCTACACTGACACAATCGTCGGCAGCGTC
F295-AGGTAGGA	AATGATACGGCGACCACCGAGATCTACACAGGTAGGATCGTCGGCAGCGTC
F296-TCCAAGAC	AATGATACGGCGACCACCGAGATCTACACTCCAAGACTCGTCGGCAGCGTC
F297-ATCCATCG	AATGATACGGCGACCACCGAGATCTACACATCCATCGTCGTCGGCAGCGTC
F298-CAGATCCA	AATGATACGGCGACCACCGAGATCTACACCAGATCCATCGTCGGCAGCGTC
F299-GTCTCGTT	AATGATACGGCGACCACCGAGATCTACACGTCTCGTTTCGTCGGCAGCGTC
F300-GACTGCTT	AATGATACGGCGACCACCGAGATCTACACGACTGCTTTCGTCGGCAGCGTC
F301-GGATGAAC	AATGATACGGCGACCACCGAGATCTACACGGATGAACTCGTCGGCAGCGTC
F302-ACTCAAGG	AATGATACGGCGACCACCGAGATCTACACACTCAAGGTCGTCGGCAGCGTC
F303-TCTGGTAG	AATGATACGGCGACCACCGAGATCTACACTCTGGTAGTCGTCGGCAGCGTC
F304-ACCTTGGA	AATGATACGGCGACCACCGAGATCTACACACCTTGGATCGTCGGCAGCGTC
F305-CTAGCACT	AATGATACGGCGACCACCGAGATCTACACCTAGCACTTCGTCGGCAGCGTC
F306-GACGTCAA	AATGATACGGCGACCACCGAGATCTACACGACGTCAATCGTCGGCAGCGTC
F307-CGTAGCTA	AATGATACGGCGACCACCGAGATCTACACCGTAGCTATCGTCGGCAGCGTC
F308-ATCAAGTG	AATGATACGGCGACCACCGAGATCTACACATCAAGTGTCGTCGGCAGCGTC
F309-GTGACTCT	AATGATACGGCGACCACCGAGATCTACACGTGACTCTTCGTCGGCAGCGTC
F310-GCTGAGAT	AATGATACGGCGACCACCGAGATCTACACGCTGAGATTCGTCGGCAGCGTC
F311-CCTCTAGA	AATGATACGGCGACCACCGAGATCTACACCCTCTAGATCGTCGGCAGCGTC
F312-GTCCATGA	AATGATACGGCGACCACCGAGATCTACACGTCCATGATCGTCGGCAGCGTC
F313-GCTACATC	AATGATACGGCGACCACCGAGATCTACACGCTACATCTCGTCGGCAGCGTC
F314-GACAGGAT	AATGATACGGCGACCACCGAGATCTACACGACAGGATTCGTCGGCAGCGTC
F315-TCCTCATC	AATGATACGGCGACCACCGAGATCTACACTCCTCATCTCGTCGGCAGCGTC
F316-AGGTGCAT	AATGATACGGCGACCACCGAGATCTACACAGGTGCATTCGTCGGCAGCGTC
F317-AAGCACTT	AATGATACGGCGACCACCGAGATCTACACAAGCACTTTCGTCGGCAGCGTC
F318-ACAAGTGC	AATGATACGGCGACCACCGAGATCTACACACAAGTGCTCGTCGGCAGCGTC
F319-AGATCTGG	AATGATACGGCGACCACCGAGATCTACACAGATCTGGTCGTCGGCAGCGTC
F320-AGTGTGCA	AATGATACGGCGACCACCGAGATCTACACAGTGTGCATCGTCGGCAGCGTC
F321-GTACACAG	AATGATACGGCGACCACCGAGATCTACACGTACACAGTCGTCGGCAGCGTC
F322-CACTCCAA	AATGATACGGCGACCACCGAGATCTACACCACTCCAATCGTCGGCAGCGTC
F323-GTTGTTCC	AATGATACGGCGACCACCGAGATCTACACGTTGTTCCTCGTCGGCAGCGTC
F324-TGTCTTGG	AATGATACGGCGACCACCGAGATCTACACTGTCTTGGTCGTCGGCAGCGTC
F325-AGTGTTGC	AATGATACGGCGACCACCGAGATCTACACAGTGTTGCTCGTCGGCAGCGTC
F326-CTCATCTA	AATGATACGGCGACCACCGAGATCTACACCTCATCTATCGTCGGCAGCGTC
F327-TCACATCG	AATGATACGGCGACCACCGAGATCTACACTCACATCGTCGTCGGCAGCGTC
F328-AGTCAGAC	AATGATACGGCGACCACCGAGATCTACACAGTCAGACTCGTCGGCAGCGTC
F329-AGTGAACC	AATGATACGGCGACCACCGAGATCTACACAGTGAACCTCGTCGGCAGCGTC
F330-TCGTCCTT	AATGATACGGCGACCACCGAGATCTACACTCGTCCTTTCGTCGGCAGCGTC
F331-GAAGCAGT	AATGATACGGCGACCACCGAGATCTACACGAAGCAGTTCGTCGGCAGCGTC
F332-ACAGGTTG	AATGATACGGCGACCACCGAGATCTACACACAGGTTGTCGTCGGCAGCGTC
F333-TACGTTCC	AATGATACGGCGACCACCGAGATCTACACTACGTTCCTCGTCGGCAGCGTC
F334-TGTAGAAG	AATGATACGGCGACCACCGAGATCTACACTGTAGAAGTCGTCGGCAGCGTC
F335-TTCCACTG	AATGATACGGCGACCACCGAGATCTACACTTCCACTGTCGTCGGCAGCGTC
F336-ACTCTGAA	AATGATACGGCGACCACCGAGATCTACACACTCTGAATCGTCGGCAGCGTC
F337-AGTCACCT	AATGATACGGCGACCACCGAGATCTACACAGTCACCTTCGTCGGCAGCGTC
F338-AGCTGGAA	AATGATACGGCGACCACCGAGATCTACACAGCTGGAATCGTCGGCAGCGTC
F339-GGATGTCT	AATGATACGGCGACCACCGAGATCTACACGGATGTCTTCGTCGGCAGCGTC
F340-ACGACTTC	AATGATACGGCGACCACCGAGATCTACACACGACTTCTCGTCGGCAGCGTC
F341-TCGAGAAC	AATGATACGGCGACCACCGAGATCTACACTCGAGAACTCGTCGGCAGCGTC
F342-GATGACTT	AATGATACGGCGACCACCGAGATCTACACGATGACTTTCGTCGGCAGCGTC
F343-TGGTCAGA	AATGATACGGCGACCACCGAGATCTACACTGGTCAGATCGTCGGCAGCGTC
F344-TTCCTAGC	AATGATACGGCGACCACCGAGATCTACACTTCCTAGCTCGTCGGCAGCGTC
F345-ACAACTCA	AATGATACGGCGACCACCGAGATCTACACACAACTCATCGTCGGCAGCGTC
F346-ATGTGGTG	AATGATACGGCGACCACCGAGATCTACACATGTGGTGTCGTCGGCAGCGTC
F347-CAACAGCT	AATGATACGGCGACCACCGAGATCTACACCAACAGCTTCGTCGGCAGCGTC
F348-TCCTTCTG	AATGATACGGCGACCACCGAGATCTACACTCCTTCTGTCGTCGGCAGCGTC
F349-TCATCTCC	AATGATACGGCGACCACCGAGATCTACACTCATCTCCTCGTCGGCAGCGTC
F350-CCTTCCTA	AATGATACGGCGACCACCGAGATCTACACCCTTCCTATCGTCGGCAGCGTC
F351-AAGTAGAC	AATGATACGGCGACCACCGAGATCTACACAAGTAGACTCGTCGGCAGCGTC
F352-GTTGGAGT	AATGATACGGCGACCACCGAGATCTACACGTTGGAGTTCGTCGGCAGCGTC
F353-GTACGACT	AATGATACGGCGACCACCGAGATCTACACGTACGACTTCGTCGGCAGCGTC
F354-ACGTCTGA	AATGATACGGCGACCACCGAGATCTACACACGTCTGATCGTCGGCAGCGTC
F355-ACAACCTG	AATGATACGGCGACCACCGAGATCTACACACAACCTGTCGTCGGCAGCGTC
F356-GTCCTCAT	AATGATACGGCGACCACCGAGATCTACACGTCCTCATTCGTCGGCAGCGTC
F357-TACCAGTA	AATGATACGGCGACCACCGAGATCTACACTACCAGTATCGTCGGCAGCGTC
F358-TGAAGCAC	AATGATACGGCGACCACCGAGATCTACACTGAAGCACTCGTCGGCAGCGTC
F359-CGTGTTCT	AATGATACGGCGACCACCGAGATCTACACCGTGTTCTTCGTCGGCAGCGTC
F360-CTTCGTGT	AATGATACGGCGACCACCGAGATCTACACCTTCGTGTTCGTCGGCAGCGTC
F361-GTCACTTC	AATGATACGGCGACCACCGAGATCTACACGTCACTTCTCGTCGGCAGCGTC
F362-TGACTAGA	AATGATACGGCGACCACCGAGATCTACACTGACTAGATCGTCGGCAGCGTC
F363-GAGTACAT	AATGATACGGCGACCACCGAGATCTACACGAGTACATTCGTCGGCAGCGTC
F364-CAGCTTCT	AATGATACGGCGACCACCGAGATCTACACCAGCTTCTTCGTCGGCAGCGTC
F365-CGAACTCT	AATGATACGGCGACCACCGAGATCTACACCGAACTCTTCGTCGGCAGCGTC
F366-AAGTTGCA	AATGATACGGCGACCACCGAGATCTACACAAGTTGCATCGTCGGCAGCGTC
F367-ACCTGATG	AATGATACGGCGACCACCGAGATCTACACACCTGATGTCGTCGGCAGCGTC
F368-ACATCGTA	AATGATACGGCGACCACCGAGATCTACACACATCGTATCGTCGGCAGCGTC
F369-TGAACCTA	AATGATACGGCGACCACCGAGATCTACACTGAACCTATCGTCGGCAGCGTC
F370-TGTACTGA	AATGATACGGCGACCACCGAGATCTACACTGTACTGATCGTCGGCAGCGTC
F371-GGTGTCAT	AATGATACGGCGACCACCGAGATCTACACGGTGTCATTCGTCGGCAGCGTC
F372-CATGGACT	AATGATACGGCGACCACCGAGATCTACACCATGGACTTCGTCGGCAGCGTC
F373-TGGATCAT	AATGATACGGCGACCACCGAGATCTACACTGGATCATTCGTCGGCAGCGTC
F374-TGATCAAG	AATGATACGGCGACCACCGAGATCTACACTGATCAAGTCGTCGGCAGCGTC
F375-TAGTGTTC	AATGATACGGCGACCACCGAGATCTACACTAGTGTTCTCGTCGGCAGCGTC
F376-ACCTAGTC	AATGATACGGCGACCACCGAGATCTACACACCTAGTCTCGTCGGCAGCGTC
F377-GTGTACTG	AATGATACGGCGACCACCGAGATCTACACGTGTACTGTCGTCGGCAGCGTC
F378-GTGAAGTA	AATGATACGGCGACCACCGAGATCTACACGTGAAGTATCGTCGGCAGCGTC
F379-CCTAGCAT	AATGATACGGCGACCACCGAGATCTACACCCTAGCATTCGTCGGCAGCGTC
F380-AACGTGAC	AATGATACGGCGACCACCGAGATCTACACAACGTGACTCGTCGGCAGCGTC
F381-TCCATGGT	AATGATACGGCGACCACCGAGATCTACACTCCATGGTTCGTCGGCAGCGTC
F382-ATCGACCA	AATGATACGGCGACCACCGAGATCTACACATCGACCATCGTCGGCAGCGTC
F383-ATGCAGAA	AATGATACGGCGACCACCGAGATCTACACATGCAGAATCGTCGGCAGCGTC
F384-AACCTAGG	AATGATACGGCGACCACCGAGATCTACACAACCTAGGTCGTCGGCAGCGTC
