R001-TTGCAGGT	CAAGCAGAAGACGGCATACGAGATTTGCAGGTGTCTCGTGGGCTCGG
R002-CAAGGAAC	CAAGCAGAAGACGGCATACGAGATCAAGGAACGTCTCGTGGGCTCGG
R003-AGATCTGG	CAAGCAGAAGACGGCATACGAGATAGATCTGGGTCTCGTGGGCTCGG
R004-TCACACTT	CAAGCAGAAGACGGCATACGAGATTCACACTTGTCTCGTGGGCTCGG
R005-GATCATGG	CAAGCAGAAGACGGCATACGAGATGATCATGGGTCTCGTGGGCTCGG
R006-AGACATGA	CAAGCAGAAGACGGCATACGAGATAGACATGAGTCTCGTGGGCTCGG
R007-ACCACGAA	CAAGCAGAAGACGGCATACGAGATACCACGAAGTCTCGTGGGCTCGG
R008-TACGTTCC	CAAGCAGAAGACGGCATACGAGATTACGTTCCGTCTCGTGGGCTCGG
R009-GACTGACA	CAAGCAGAAGACGGCATACGAGATGACTGACAGTCTCGTGGGCTCGG
R010-GTGATCTT	CAAGCAGAAGACGGCATACGAGATGTGATCTTGTCTCGTGGGCTCGG
R011-CGTTCAAC	CAAGCAGAAGACGGCATACGAGATCGTTCAACGTCTCGTGGGCTCGG
R012-CTGACCAA	CAAGCAGAAGACGGCATACGAGATCTGACCAAGTCTCGTGGGCTCGG
R013-GTGAGTTG	CAAGCAGAAGACGGCATACGAGATGTGAGTTGGTCTCGTGGGCTCGG
R014-AGTCTGTT	CAAGCAGAAGACGGCATACGAGATAGTCTGTTGTCTCGTGGGCTCGG
R015-AACCAACC	CAAGCAGAAGACGGCATACGAGATAACCAACCGTCTCGTGGGCTCGG
R016-AGTGTGCA	CAAGCAGAAGACGGCATACGAGATAGTGTGCAGTCTCGTGGGCTCGG
R017-CATGTCGA	CAAGCAGAAGACGGCATACGAGATCATGTCGAGTCTCGTGGGCTCGG
R018-CGAGACTT	CAAGCAGAAGACGGCATACGAGATCGAGACTTGTCTCGTGGGCTCGG
R019-GCATCATG	CAAGCAGAAGACGGCATACGAGATGCATCATGGTCTCGTGGGCTCGG
R020-CACTTGGT	CAAGCAGAAGACGGCATACGAGATCACTTGGTGTCTCGTGGGCTCGG
R021-GTGTGCAA	CAAGCAGAAGACGGCATACGAGATGTGTGCAAGTCTCGTGGGCTCGG
R022-TCTCCAAC	CAAGCAGAAGACGGCATACGAGATTCTCCAACGTCTCGTGGGCTCGG
R023-GTGACAAC	CAAGCAGAAGACGGCATACGAGATGTGACAACGTCTCGTGGGCTCGG
R024-TCATGTGG	CAAGCAGAAGACGGCATACGAGATTCATGTGGGTCTCGTGGGCTCGG
R025-ATGGTGGT	CAAGCAGAAGACGGCATACGAGATATGGTGGTGTCTCGTGGGCTCGG
R026-AGTCGTTG	CAAGCAGAAGACGGCATACGAGATAGTCGTTGGTCTCGTGGGCTCGG
R027-CACCTTGA	CAAGCAGAAGACGGCATACGAGATCACCTTGAGTCTCGTGGGCTCGG
R028-CAACAGCT	CAAGCAGAAGACGGCATACGAGATCAACAGCTGTCTCGTGGGCTCGG
R029-TCAACCAT	CAAGCAGAAGACGGCATACGAGATTCAACCATGTCTCGTGGGCTCGG
R030-TTCATCCT	CAAGCAGAAGACGGCATACGAGATTTCATCCTGTCTCGTGGGCTCGG
R031-CTCACATG	CAAGCAGAAGACGGCATACGAGATCTCACATGGTCTCGTGGGCTCGG
R032-GTGTACTG	CAAGCAGAAGACGGCATACGAGATGTGTACTGGTCTCGTGGGCTCGG
R033-TACTCACG	CAAGCAGAAGACGGCATACGAGATTACTCACGGTCTCGTGGGCTCGG
R034-GAAGTACC	CAAGCAGAAGACGGCATACGAGATGAAGTACCGTCTCGTGGGCTCGG
R035-TCGAGAAC	CAAGCAGAAGACGGCATACGAGATTCGAGAACGTCTCGTGGGCTCGG
R036-GGTGAGTA	CAAGCAGAAGACGGCATACGAGATGGTGAGTAGTCTCGTGGGCTCGG
R037-GTCCATGA	CAAGCAGAAGACGGCATACGAGATGTCCATGAGTCTCGTGGGCTCGG
R038-TGGAGACA	CAAGCAGAAGACGGCATACGAGATTGGAGACAGTCTCGTGGGCTCGG
R039-AGTACACG	CAAGCAGAAGACGGCATACGAGATAGTACACGGTCTCGTGGGCTCGG
R040-TGATCGTT	CAAGCAGAAGACGGCATACGAGATTGATCGTTGTCTCGTGGGCTCGG
R041-GTTGGAGT	CAAGCAGAAGACGGCATACGAGATGTTGGAGTGTCTCGTGGGCTCGG
R042-CATGACAG	CAAGCAGAAGACGGCATACGAGATCATGACAGGTCTCGTGGGCTCGG
R043-TGTCGTCT	CAAGCAGAAGACGGCATACGAGATTGTCGTCTGTCTCGTGGGCTCGG
R044-TCAGTCTC	CAAGCAGAAGACGGCATACGAGATTCAGTCTCGTCTCGTGGGCTCGG
R045-ACCTGTCA	CAAGCAGAAGACGGCATACGAGATACCTGTCAGTCTCGTGGGCTCGG
R046-GAAGCTTC	CAAGCAGAAGACGGCATACGAGATGAAGCTTCGTCTCGTGGGCTCGG
R047-CTGCTGAT	CAAGCAGAAGACGGCATACGAGATCTGCTGATGTCTCGTGGGCTCGG
R048-ATGTCCAC	CAAGCAGAAGACGGCATACGAGATATGTCCACGTCTCGTGGGCTCGG
R049-ATCGACCA	CAAGCAGAAGACGGCATACGAGATATCGACCAGTCTCGTGGGCTCGG
R050-GTTCCTAC	CAAGCAGAAGACGGCATACGAGATGTTCCTACGTCTCGTGGGCTCGG
R051-CTTGAAGG	CAAGCAGAAGACGGCATACGAGATCTTGAAGGGTCTCGTGGGCTCGG
R052-ACACCTAG	CAAGCAGAAGACGGCATACGAGATACACCTAGGTCTCGTGGGCTCGG
R053-TGCAACAG	CAAGCAGAAGACGGCATACGAGATTGCAACAGGTCTCGTGGGCTCGG
R054-TCGTTCGA	CAAGCAGAAGACGGCATACGAGATTCGTTCGAGTCTCGTGGGCTCGG
R055-ACCACAGT	CAAGCAGAAGACGGCATACGAGATACCACAGTGTCTCGTGGGCTCGG
R056-CTTGCATC	CAAGCAGAAGACGGCATACGAGATCTTGCATCGTCTCGTGGGCTCGG
R057-TCTTGGTT	CAAGCAGAAGACGGCATACGAGATTCTTGGTTGTCTCGTGGGCTCGG
R058-GGATGTCT	CAAGCAGAAGACGGCATACGAGATGGATGTCTGTCTCGTGGGCTCGG
R059-CAAGTGTC	CAAGCAGAAGACGGCATACGAGATCAAGTGTCGTCTCGTGGGCTCGG
R060-AAGAAGGT	CAAGCAGAAGACGGCATACGAGATAAGAAGGTGTCTCGTGGGCTCGG
R061-TCGATGCA	CAAGCAGAAGACGGCATACGAGATTCGATGCAGTCTCGTGGGCTCGG
R062-GAGTGTGA	CAAGCAGAAGACGGCATACGAGATGAGTGTGAGTCTCGTGGGCTCGG
R063-CCTACGTT	CAAGCAGAAGACGGCATACGAGATCCTACGTTGTCTCGTGGGCTCGG
R064-GGAACTAC	CAAGCAGAAGACGGCATACGAGATGGAACTACGTCTCGTGGGCTCGG
R065-GTCTAGAG	CAAGCAGAAGACGGCATACGAGATGTCTAGAGGTCTCGTGGGCTCGG
R066-AGACTACC	CAAGCAGAAGACGGCATACGAGATAGACTACCGTCTCGTGGGCTCGG
R067-TCCACACA	CAAGCAGAAGACGGCATACGAGATTCCACACAGTCTCGTGGGCTCGG
R068-GAACGTAG	CAAGCAGAAGACGGCATACGAGATGAACGTAGGTCTCGTGGGCTCGG
R069-TAGGATGG	CAAGCAGAAGACGGCATACGAGATTAGGATGGGTCTCGTGGGCTCGG
R070-TCAGACGA	CAAGCAGAAGACGGCATACGAGATTCAGACGAGTCTCGTGGGCTCGG
R071-CTTGTGAG	CAAGCAGAAGACGGCATACGAGATCTTGTGAGGTCTCGTGGGCTCGG
R072-AAGCACTT	CAAGCAGAAGACGGCATACGAGATAAGCACTTGTCTCGTGGGCTCGG
R073-TCTGGTAG	CAAGCAGAAGACGGCATACGAGATTCTGGTAGGTCTCGTGGGCTCGG
R074-GATCTCAG	CAAGCAGAAGACGGCATACGAGATGATCTCAGGTCTCGTGGGCTCGG
R075-CAACCTGT	CAAGCAGAAGACGGCATACGAGATCAACCTGTGTCTCGTGGGCTCGG
R076-ATCTCACC	CAAGCAGAAGACGGCATACGAGATATCTCACCGTCTCGTGGGCTCGG
R077-ACAACTCA	CAAGCAGAAGACGGCATACGAGATACAACTCAGTCTCGTGGGCTCGG
R078-GTAGAGGT	CAAGCAGAAGACGGCATACGAGATGTAGAGGTGTCTCGTGGGCTCGG
R079-AGAGGACA	CAAGCAGAAGACGGCATACGAGATAGAGGACAGTCTCGTGGGCTCGG
R080-TGGATCAT	CAAGCAGAAGACGGCATACGAGATTGGATCATGTCTCGTGGGCTCGG
R081-TACTACTC	CAAGCAGAAGACGGCATACGAGATTACTACTCGTCTCGTGGGCTCGG
R082-CAGTGATG	CAAGCAGAAGACGGCATACGAGATCAGTGATGGTCTCGTGGGCTCGG
R083-GTCAAGCT	CAAGCAGAAGACGGCATACGAGATGTCAAGCTGTCTCGTGGGCTCGG
R084-TTCTGAGA	CAAGCAGAAGACGGCATACGAGATTTCTGAGAGTCTCGTGGGCTCGG
R085-GATGTGCT	CAAGCAGAAGACGGCATACGAGATGATGTGCTGTCTCGTGGGCTCGG
R086-TCGAACTA	CAAGCAGAAGACGGCATACGAGATTCGAACTAGTCTCGTGGGCTCGG
R087-ACGTCTGA	CAAGCAGAAGACGGCATACGAGATACGTCTGAGTCTCGTGGGCTCGG
R088-CATCGAAG	CAAGCAGAAGACGGCATACGAGATCATCGAAGGTCTCGTGGGCTCGG
R089-AGAACGAG	CAAGCAGAAGACGGCATACGAGATAGAACGAGGTCTCGTGGGCTCGG
R090-ACAGACCT	CAAGCAGAAGACGGCATACGAGATACAGACCTGTCTCGTGGGCTCGG
R091-CACAGTAC	CAAGCAGAAGACGGCATACGAGATCACAGTACGTCTCGTGGGCTCGG
R092-TTCCTAGC	CAAGCAGAAGACGGCATACGAGATTTCCTAGCGTCTCGTGGGCTCGG
R093-TGGTCAGA	CAAGCAGAAGACGGCATACGAGATTGGTCAGAGTCTCGTGGGCTCGG
R094-CTGATGTG	CAAGCAGAAGACGGCATACGAGATCTGATGTGGTCTCGTGGGCTCGG
R095-ACTGTCGT	CAAGCAGAAGACGGCATACGAGATACTGTCGTGTCTCGTGGGCTCGG
R096-GATGGTCA	CAAGCAGAAGACGGCATACGAGATGATGGTCAGTCTCGTGGGCTCGG
R097-GTTGTTCC	CAAGCAGAAGACGGCATACGAGATGTTGTTCCGTCTCGTGGGCTCGG
R098-TGTGACTC	CAAGCAGAAGACGGCATACGAGATTGTGACTCGTCTCGTGGGCTCGG
R099-TGTCAAGC	CAAGCAGAAGACGGCATACGAGATTGTCAAGCGTCTCGTGGGCTCGG
R100-ACACTCGA	CAAGCAGAAGACGGCATACGAGATACACTCGAGTCTCGTGGGCTCGG
R101-CAACTGAG	CAAGCAGAAGACGGCATACGAGATCAACTGAGGTCTCGTGGGCTCGG
R102-ACCTGATG	CAAGCAGAAGACGGCATACGAGATACCTGATGGTCTCGTGGGCTCGG
R103-GAAGCAGT	CAAGCAGAAGACGGCATACGAGATGAAGCAGTGTCTCGTGGGCTCGG
R104-CTGTACCT	CAAGCAGAAGACGGCATACGAGATCTGTACCTGTCTCGTGGGCTCGG
R105-AAGAGGAA	CAAGCAGAAGACGGCATACGAGATAAGAGGAAGTCTCGTGGGCTCGG
R106-TACACGTT	CAAGCAGAAGACGGCATACGAGATTACACGTTGTCTCGTGGGCTCGG
R107-TGACACAA	CAAGCAGAAGACGGCATACGAGATTGACACAAGTCTCGTGGGCTCGG
R108-AGTGCTAG	CAAGCAGAAGACGGCATACGAGATAGTGCTAGGTCTCGTGGGCTCGG
R109-TCCTGCAT	CAAGCAGAAGACGGCATACGAGATTCCTGCATGTCTCGTGGGCTCGG
R110-TGAGAGAT	CAAGCAGAAGACGGCATACGAGATTGAGAGATGTCTCGTGGGCTCGG
R111-CTAGTTCG	CAAGCAGAAGACGGCATACGAGATCTAGTTCGGTCTCGTGGGCTCGG
R112-GTCCTCAT	CAAGCAGAAGACGGCATACGAGATGTCCTCATGTCTCGTGGGCTCGG
R113-GATGAAGA	CAAGCAGAAGACGGCATACGAGATGATGAAGAGTCTCGTGGGCTCGG
R114-ACAACCTG	CAAGCAGAAGACGGCATACGAGATACAACCTGGTCTCGTGGGCTCGG
R115-ATGATCGA	CAAGCAGAAGACGGCATACGAGATATGATCGAGTCTCGTGGGCTCGG
R116-TGTGATCA	CAAGCAGAAGACGGCATACGAGATTGTGATCAGTCTCGTGGGCTCGG
R117-CTGTGTAC	CAAGCAGAAGACGGCATACGAGATCTGTGTACGTCTCGTGGGCTCGG
R118-TGCAAGGA	CAAGCAGAAGACGGCATACGAGATTGCAAGGAGTCTCGTGGGCTCGG
R119-AAGTCATC	CAAGCAGAAGACGGCATACGAGATAAGTCATCGTCTCGTGGGCTCGG
R120-GCACTTGT	CAAGCAGAAGACGGCATACGAGATGCACTTGTGTCTCGTGGGCTCGG
R121-TCATGCTA	CAAGCAGAAGACGGCATACGAGATTCATGCTAGTCTCGTGGGCTCGG
R122-TAGAGTGT	CAAGCAGAAGACGGCATACGAGATTAGAGTGTGTCTCGTGGGCTCGG
R123-ACACTGTG	CAAGCAGAAGACGGCATACGAGATACACTGTGGTCTCGTGGGCTCGG
R124-AACCAGAG	CAAGCAGAAGACGGCATACGAGATAACCAGAGGTCTCGTGGGCTCGG
R125-GTTGCTGA	CAAGCAGAAGACGGCATACGAGATGTTGCTGAGTCTCGTGGGCTCGG
R126-CAACTACA	CAAGCAGAAGACGGCATACGAGATCAACTACAGTCTCGTGGGCTCGG
R127-TGTCAGTG	CAAGCAGAAGACGGCATACGAGATTGTCAGTGGTCTCGTGGGCTCGG
R128-AGTACCAC	CAAGCAGAAGACGGCATACGAGATAGTACCACGTCTCGTGGGCTCGG
R129-GAAGTTGA	CAAGCAGAAGACGGCATACGAGATGAAGTTGAGTCTCGTGGGCTCGG
R130-ATGGTACC	CAAGCAGAAGACGGCATACGAGATATGGTACCGTCTCGTGGGCTCGG
R131-TTGAGGTT	CAAGCAGAAGACGGCATACGAGATTTGAGGTTGTCTCGTGGGCTCGG
R132-CTCTACAC	CAAGCAGAAGACGGCATACGAGATCTCTACACGTCTCGTGGGCTCGG
R133-CTTGAGCA	CAAGCAGAAGACGGCATACGAGATCTTGAGCAGTCTCGTGGGCTCGG
R134-CTGTTGGA	CAAGCAGAAGACGGCATACGAGATCTGTTGGAGTCTCGTGGGCTCGG
R135-ACAAGTGC	CAAGCAGAAGACGGCATACGAGATACAAGTGCGTCTCGTGGGCTCGG
R136-GGTACCTT	CAAGCAGAAGACGGCATACGAGATGGTACCTTGTCTCGTGGGCTCGG
R137-GATCTAGC	CAAGCAGAAGACGGCATACGAGATGATCTAGCGTCTCGTGGGCTCGG
R138-ATCTGTTC	CAAGCAGAAGACGGCATACGAGATATCTGTTCGTCTCGTGGGCTCGG
R139-TAGTCCAG	CAAGCAGAAGACGGCATACGAGATTAGTCCAGGTCTCGTGGGCTCGG
R140-TACCATGC	CAAGCAGAAGACGGCATACGAGATTACCATGCGTCTCGTGGGCTCGG
R141-AGGTTGAG	CAAGCAGAAGACGGCATACGAGATAGGTTGAGGTCTCGTGGGCTCGG
R142-GTGACTCT	CAAGCAGAAGACGGCATACGAGATGTGACTCTGTCTCGTGGGCTCGG
R143-TCAGTACG	CAAGCAGAAGACGGCATACGAGATTCAGTACGGTCTCGTGGGCTCGG
R144-TACAGATG	CAAGCAGAAGACGGCATACGAGATTACAGATGGTCTCGTGGGCTCGG
R145-TCTGAAGT	CAAGCAGAAGACGGCATACGAGATTCTGAAGTGTCTCGTGGGCTCGG
R146-ATGTGACA	CAAGCAGAAGACGGCATACGAGATATGTGACAGTCTCGTGGGCTCGG
R147-CCTACAAG	CAAGCAGAAGACGGCATACGAGATCCTACAAGGTCTCGTGGGCTCGG
R148-GTTCTCGA	CAAGCAGAAGACGGCATACGAGATGTTCTCGAGTCTCGTGGGCTCGG
R149-ATCGTCTT	CAAGCAGAAGACGGCATACGAGATATCGTCTTGTCTCGTGGGCTCGG
R150-AAGACGTG	CAAGCAGAAGACGGCATACGAGATAAGACGTGGTCTCGTGGGCTCGG
R151-GCATCGAT	CAAGCAGAAGACGGCATACGAGATGCATCGATGTCTCGTGGGCTCGG
R152-ACTCATCC	CAAGCAGAAGACGGCATACGAGATACTCATCCGTCTCGTGGGCTCGG
R153-GGATGAAC	CAAGCAGAAGACGGCATACGAGATGGATGAACGTCTCGTGGGCTCGG
R154-TGCATGTC	CAAGCAGAAGACGGCATACGAGATTGCATGTCGTCTCGTGGGCTCGG
R155-CGAAGTGA	CAAGCAGAAGACGGCATACGAGATCGAAGTGAGTCTCGTGGGCTCGG
R156-TACTCTGT	CAAGCAGAAGACGGCATACGAGATTACTCTGTGTCTCGTGGGCTCGG
R157-AGAACAGA	CAAGCAGAAGACGGCATACGAGATAGAACAGAGTCTCGTGGGCTCGG
R158-AGTCCAGT	CAAGCAGAAGACGGCATACGAGATAGTCCAGTGTCTCGTGGGCTCGG
R159-CTCCAGTT	CAAGCAGAAGACGGCATACGAGATCTCCAGTTGTCTCGTGGGCTCGG
R160-GACGTCAA	CAAGCAGAAGACGGCATACGAGATGACGTCAAGTCTCGTGGGCTCGG
R161-TCATCTCC	CAAGCAGAAGACGGCATACGAGATTCATCTCCGTCTCGTGGGCTCGG
R162-TGCTTCAA	CAAGCAGAAGACGGCATACGAGATTGCTTCAAGTCTCGTGGGCTCGG
R163-ACAAGGTT	CAAGCAGAAGACGGCATACGAGATACAAGGTTGTCTCGTGGGCTCGG
R164-CTACGTCA	CAAGCAGAAGACGGCATACGAGATCTACGTCAGTCTCGTGGGCTCGG
R165-ACTCTACT	CAAGCAGAAGACGGCATACGAGATACTCTACTGTCTCGTGGGCTCGG
R166-CACTAGTG	CAAGCAGAAGACGGCATACGAGATCACTAGTGGTCTCGTGGGCTCGG
R167-TTGGTGTC	CAAGCAGAAGACGGCATACGAGATTTGGTGTCGTCTCGTGGGCTCGG
R168-GAGAGAAG	CAAGCAGAAGACGGCATACGAGATGAGAGAAGGTCTCGTGGGCTCGG
R169-CTTCGTGT	CAAGCAGAAGACGGCATACGAGATCTTCGTGTGTCTCGTGGGCTCGG
R170-TGACTAGA	CAAGCAGAAGACGGCATACGAGATTGACTAGAGTCTCGTGGGCTCGG
R171-GTGAAGTA	CAAGCAGAAGACGGCATACGAGATGTGAAGTAGTCTCGTGGGCTCGG
R172-TGCAGCTT	CAAGCAGAAGACGGCATACGAGATTGCAGCTTGTCTCGTGGGCTCGG
R173-TTGTCGAT	CAAGCAGAAGACGGCATACGAGATTTGTCGATGTCTCGTGGGCTCGG
R174-CTAGGTTC	CAAGCAGAAGACGGCATACGAGATCTAGGTTCGTCTCGTGGGCTCGG
R175-ACATCACT	CAAGCAGAAGACGGCATACGAGATACATCACTGTCTCGTGGGCTCGG
R176-AACGTGAC	CAAGCAGAAGACGGCATACGAGATAACGTGACGTCTCGTGGGCTCGG
R177-GCTACCAA	CAAGCAGAAGACGGCATACGAGATGCTACCAAGTCTCGTGGGCTCGG
R178-TCACATCG	CAAGCAGAAGACGGCATACGAGATTCACATCGGTCTCGTGGGCTCGG
R179-AACGACTG	CAAGCAGAAGACGGCATACGAGATAACGACTGGTCTCGTGGGCTCGG
R180-ACTGGAAC	CAAGCAGAAGACGGCATACGAGATACTGGAACGTCTCGTGGGCTCGG
R181-GAACGAGA	CAAGCAGAAGACGGCATACGAGATGAACGAGAGTCTCGTGGGCTCGG
R182-AGACCTTC	CAAGCAGAAGACGGCATACGAGATAGACCTTCGTCTCGTGGGCTCGG
R183-AACCTGCT	CAAGCAGAAGACGGCATACGAGATAACCTGCTGTCTCGTGGGCTCGG
R184-CATGGTTG	CAAGCAGAAGACGGCATACGAGATCATGGTTGGTCTCGTGGGCTCGG
R185-TTCGTCAG	CAAGCAGAAGACGGCATACGAGATTTCGTCAGGTCTCGTGGGCTCGG
R186-TGTCCACA	CAAGCAGAAGACGGCATACGAGATTGTCCACAGTCTCGTGGGCTCGG
R187-TGAGGTGT	CAAGCAGAAGACGGCATACGAGATTGAGGTGTGTCTCGTGGGCTCGG
R188-CTGTAGTC	CAAGCAGAAGACGGCATACGAGATCTGTAGTCGTCTCGTGGGCTCGG
R189-GAGAACGA	CAAGCAGAAGACGGCATACGAGATGAGAACGAGTCTCGTGGGCTCGG
R190-GTCACAGA	CAAGCAGAAGACGGCATACGAGATGTCACAGAGTCTCGTGGGCTCGG
R191-TCGTAGTG	CAAGCAGAAGACGGCATACGAGATTCGTAGTGGTCTCGTGGGCTCGG
R192-ACCAGTAG	CAAGCAGAAGACGGCATACGAGATACCAGTAGGTCTCGTGGGCTCGG
R193-TCTCAGCT	CAAGCAGAAGACGGCATACGAGATTCTCAGCTGTCTCGTGGGCTCGG
R194-GGAAGGAA	CAAGCAGAAGACGGCATACGAGATGGAAGGAAGTCTCGTGGGCTCGG
R195-ACACGTCT	CAAGCAGAAGACGGCATACGAGATACACGTCTGTCTCGTGGGCTCGG
R196-ATCAAGTG	CAAGCAGAAGACGGCATACGAGATATCAAGTGGTCTCGTGGGCTCGG
R197-AGAGTCTA	CAAGCAGAAGACGGCATACGAGATAGAGTCTAGTCTCGTGGGCTCGG
R198-TCTTGACC	CAAGCAGAAGACGGCATACGAGATTCTTGACCGTCTCGTGGGCTCGG
R199-GTACAAGC	CAAGCAGAAGACGGCATACGAGATGTACAAGCGTCTCGTGGGCTCGG
R200-ACTCGTGA	CAAGCAGAAGACGGCATACGAGATACTCGTGAGTCTCGTGGGCTCGG
R201-TAGGTGAT	CAAGCAGAAGACGGCATACGAGATTAGGTGATGTCTCGTGGGCTCGG
R202-CACTCCAA	CAAGCAGAAGACGGCATACGAGATCACTCCAAGTCTCGTGGGCTCGG
R203-TGGTCTTG	CAAGCAGAAGACGGCATACGAGATTGGTCTTGGTCTCGTGGGCTCGG
R204-CAGACAGT	CAAGCAGAAGACGGCATACGAGATCAGACAGTGTCTCGTGGGCTCGG
R205-AAGACCAT	CAAGCAGAAGACGGCATACGAGATAAGACCATGTCTCGTGGGCTCGG
R206-GTCAACAA	CAAGCAGAAGACGGCATACGAGATGTCAACAAGTCTCGTGGGCTCGG
R207-AACCTAGG	CAAGCAGAAGACGGCATACGAGATAACCTAGGGTCTCGTGGGCTCGG
R208-CAACCATG	CAAGCAGAAGACGGCATACGAGATCAACCATGGTCTCGTGGGCTCGG
R209-GTCACTTC	CAAGCAGAAGACGGCATACGAGATGTCACTTCGTCTCGTGGGCTCGG
R210-CTAGGAGA	CAAGCAGAAGACGGCATACGAGATCTAGGAGAGTCTCGTGGGCTCGG
R211-AGGTGCAT	CAAGCAGAAGACGGCATACGAGATAGGTGCATGTCTCGTGGGCTCGG
R212-TCTCTGTC	CAAGCAGAAGACGGCATACGAGATTCTCTGTCGTCTCGTGGGCTCGG
R213-GGTTGAGA	CAAGCAGAAGACGGCATACGAGATGGTTGAGAGTCTCGTGGGCTCGG
R214-TCTGCTCT	CAAGCAGAAGACGGCATACGAGATTCTGCTCTGTCTCGTGGGCTCGG
R215-CACTGTCT	CAAGCAGAAGACGGCATACGAGATCACTGTCTGTCTCGTGGGCTCGG
R216-CCACAGTA	CAAGCAGAAGACGGCATACGAGATCCACAGTAGTCTCGTGGGCTCGG
R217-GACTGCTT	CAAGCAGAAGACGGCATACGAGATGACTGCTTGTCTCGTGGGCTCGG
R218-GTGCTACA	CAAGCAGAAGACGGCATACGAGATGTGCTACAGTCTCGTGGGCTCGG
R219-GTACACAG	CAAGCAGAAGACGGCATACGAGATGTACACAGGTCTCGTGGGCTCGG
R220-TGAGAAGG	CAAGCAGAAGACGGCATACGAGATTGAGAAGGGTCTCGTGGGCTCGG
R221-ACCTCTAC	CAAGCAGAAGACGGCATACGAGATACCTCTACGTCTCGTGGGCTCGG
R222-ACAAGACG	CAAGCAGAAGACGGCATACGAGATACAAGACGGTCTCGTGGGCTCGG
R223-TAGAAGTC	CAAGCAGAAGACGGCATACGAGATTAGAAGTCGTCTCGTGGGCTCGG
R224-AGCTGGAA	CAAGCAGAAGACGGCATACGAGATAGCTGGAAGTCTCGTGGGCTCGG
R225-CATGGACT	CAAGCAGAAGACGGCATACGAGATCATGGACTGTCTCGTGGGCTCGG
R226-ACGTACGT	CAAGCAGAAGACGGCATACGAGATACGTACGTGTCTCGTGGGCTCGG
R227-TGAGTCCT	CAAGCAGAAGACGGCATACGAGATTGAGTCCTGTCTCGTGGGCTCGG
R228-CATCCTTC	CAAGCAGAAGACGGCATACGAGATCATCCTTCGTCTCGTGGGCTCGG
R229-TTGCTTGA	CAAGCAGAAGACGGCATACGAGATTTGCTTGAGTCTCGTGGGCTCGG
R230-CGATGTAG	CAAGCAGAAGACGGCATACGAGATCGATGTAGGTCTCGTGGGCTCGG
R231-GAACCTCA	CAAGCAGAAGACGGCATACGAGATGAACCTCAGTCTCGTGGGCTCGG
R232-AACGTACA	CAAGCAGAAGACGGCATACGAGATAACGTACAGTCTCGTGGGCTCGG
R233-GGACAGTT	CAAGCAGAAGACGGCATACGAGATGGACAGTTGTCTCGTGGGCTCGG
R234-CGATCAGT	CAAGCAGAAGACGGCATACGAGATCGATCAGTGTCTCGTGGGCTCGG
R235-AGCTCCTT	CAAGCAGAAGACGGCATACGAGATAGCTCCTTGTCTCGTGGGCTCGG
R236-ACGTCAAG	CAAGCAGAAGACGGCATACGAGATACGTCAAGGTCTCGTGGGCTCGG
R237-GCTAGTAC	CAAGCAGAAGACGGCATACGAGATGCTAGTACGTCTCGTGGGCTCGG
R238-TTCGAGAA	CAAGCAGAAGACGGCATACGAGATTTCGAGAAGTCTCGTGGGCTCGG
R239-ACTAGCTC	CAAGCAGAAGACGGCATACGAGATACTAGCTCGTCTCGTGGGCTCGG
R240-GAGCTGTT	CAAGCAGAAGACGGCATACGAGATGAGCTGTTGTCTCGTGGGCTCGG
R241-ACTACTGG	CAAGCAGAAGACGGCATACGAGATACTACTGGGTCTCGTGGGCTCGG
R242-CTGTTCAG	CAAGCAGAAGACGGCATACGAGATCTGTTCAGGTCTCGTGGGCTCGG
R243-CGAACTCT	CAAGCAGAAGACGGCATACGAGATCGAACTCTGTCTCGTGGGCTCGG
R244-TCAAGGAG	CAAGCAGAAGACGGCATACGAGATTCAAGGAGGTCTCGTGGGCTCGG
R245-GATGGATC	CAAGCAGAAGACGGCATACGAGATGATGGATCGTCTCGTGGGCTCGG
R246-TCTGTCAA	CAAGCAGAAGACGGCATACGAGATTCTGTCAAGTCTCGTGGGCTCGG
R247-TTCCAACA	CAAGCAGAAGACGGCATACGAGATTTCCAACAGTCTCGTGGGCTCGG
R248-TGAGTGTG	CAAGCAGAAGACGGCATACGAGATTGAGTGTGGTCTCGTGGGCTCGG
R249-CTACTAGT	CAAGCAGAAGACGGCATACGAGATCTACTAGTGTCTCGTGGGCTCGG
R250-CTGGACTA	CAAGCAGAAGACGGCATACGAGATCTGGACTAGTCTCGTGGGCTCGG
R251-GACAGGAT	CAAGCAGAAGACGGCATACGAGATGACAGGATGTCTCGTGGGCTCGG
R252-ACCTAGTC	CAAGCAGAAGACGGCATACGAGATACCTAGTCGTCTCGTGGGCTCGG
R253-TGGACGAA	CAAGCAGAAGACGGCATACGAGATTGGACGAAGTCTCGTGGGCTCGG
R254-TAGCTACC	CAAGCAGAAGACGGCATACGAGATTAGCTACCGTCTCGTGGGCTCGG
R255-GTTCTGTG	CAAGCAGAAGACGGCATACGAGATGTTCTGTGGTCTCGTGGGCTCGG
R256-ACTTCAGC	CAAGCAGAAGACGGCATACGAGATACTTCAGCGTCTCGTGGGCTCGG
R257-GTCAGTCA	CAAGCAGAAGACGGCATACGAGATGTCAGTCAGTCTCGTGGGCTCGG
R258-GTCTCGTT	CAAGCAGAAGACGGCATACGAGATGTCTCGTTGTCTCGTGGGCTCGG
R259-AGAGCATG	CAAGCAGAAGACGGCATACGAGATAGAGCATGGTCTCGTGGGCTCGG
R260-TCCAAGAC	CAAGCAGAAGACGGCATACGAGATTCCAAGACGTCTCGTGGGCTCGG
R261-CAAGTCAT	CAAGCAGAAGACGGCATACGAGATCAAGTCATGTCTCGTGGGCTCGG
R262-CCTAGCAT	CAAGCAGAAGACGGCATACGAGATCCTAGCATGTCTCGTGGGCTCGG
R263-AGTGTTGC	CAAGCAGAAGACGGCATACGAGATAGTGTTGCGTCTCGTGGGCTCGG
R264-AAGGAACG	CAAGCAGAAGACGGCATACGAGATAAGGAACGGTCTCGTGGGCTCGG
R265-TCACGAGT	CAAGCAGAAGACGGCATACGAGATTCACGAGTGTCTCGTGGGCTCGG
R266-CTTCACAT	CAAGCAGAAGACGGCATACGAGATCTTCACATGTCTCGTGGGCTCGG
R267-GACATGTA	CAAGCAGAAGACGGCATACGAGATGACATGTAGTCTCGTGGGCTCGG
R268-TCCAGTCT	CAAGCAGAAGACGGCATACGAGATTCCAGTCTGTCTCGTGGGCTCGG
R269-TACGAGCT	CAAGCAGAAGACGGCATACGAGATTACGAGCTGTCTCGTGGGCTCGG
R270-ATGGAAGA	CAAGCAGAAGACGGCATACGAGATATGGAAGAGTCTCGTGGGCTCGG
R271-AAGCTTGC	CAAGCAGAAGACGGCATACGAGATAAGCTTGCGTCTCGTGGGCTCGG
R272-CTCTCTAG	CAAGCAGAAGACGGCATACGAGATCTCTCTAGGTCTCGTGGGCTCGG
R273-TGATCAAG	CAAGCAGAAGACGGCATACGAGATTGATCAAGGTCTCGTGGGCTCGG
R274-GATCACCA	CAAGCAGAAGACGGCATACGAGATGATCACCAGTCTCGTGGGCTCGG
R275-CGTAGCTA	CAAGCAGAAGACGGCATACGAGATCGTAGCTAGTCTCGTGGGCTCGG
R276-AGTTCTCC	CAAGCAGAAGACGGCATACGAGATAGTTCTCCGTCTCGTGGGCTCGG
R277-CCTGATGA	CAAGCAGAAGACGGCATACGAGATCCTGATGAGTCTCGTGGGCTCGG
R278-GCTCTCTT	CAAGCAGAAGACGGCATACGAGATGCTCTCTTGTCTCGTGGGCTCGG
R279-TGTTGGAC	CAAGCAGAAGACGGCATACGAGATTGTTGGACGTCTCGTGGGCTCGG
R280-TCAACGTC	CAAGCAGAAGACGGCATACGAGATTCAACGTCGTCTCGTGGGCTCGG
R281-TACCACAT	CAAGCAGAAGACGGCATACGAGATTACCACATGTCTCGTGGGCTCGG
R282-AAGACACA	CAAGCAGAAGACGGCATACGAGATAAGACACAGTCTCGTGGGCTCGG
R283-ACATGGAC	CAAGCAGAAGACGGCATACGAGATACATGGACGTCTCGTGGGCTCGG
R284-ATCAGAGG	CAAGCAGAAGACGGCATACGAGATATCAGAGGGTCTCGTGGGCTCGG
R285-GTGGTGAA	CAAGCAGAAGACGGCATACGAGATGTGGTGAAGTCTCGTGGGCTCGG
R286-CTCGATCT	CAAGCAGAAGACGGCATACGAGATCTCGATCTGTCTCGTGGGCTCGG
R287-GTTCATCT	CAAGCAGAAGACGGCATACGAGATGTTCATCTGTCTCGTGGGCTCGG
R288-AGGAGATG	CAAGCAGAAGACGGCATACGAGATAGGAGATGGTCTCGTGGGCTCGG
