R001-AAGTGCTA	CAAGCAGAAGACGGCATACGAGATAAGTGCTAGTCTCGTGGGCTCGG
R002-GTCAGTCA	CAAGCAGAAGACGGCATACGAGATGTCAGTCAGTCTCGTGGGCTCGG
R003-CAACCATG	CAAGCAGAAGACGGCATACGAGATCAACCATGGTCTCGTGGGCTCGG
R004-CGATCAGT	CAAGCAGAAGACGGCATACGAGATCGATCAGTGTCTCGTGGGCTCGG
R005-AGTCAGAC	CAAGCAGAAGACGGCATACGAGATAGTCAGACGTCTCGTGGGCTCGG
R006-GAACAGAA	CAAGCAGAAGACGGCATACGAGATGAACAGAAGTCTCGTGGGCTCGG
R007-CTTGAAGG	CAAGCAGAAGACGGCATACGAGATCTTGAAGGGTCTCGTGGGCTCGG
R008-GCTTGTGT	CAAGCAGAAGACGGCATACGAGATGCTTGTGTGTCTCGTGGGCTCGG
R009-TTCTTGAC	CAAGCAGAAGACGGCATACGAGATTTCTTGACGTCTCGTGGGCTCGG
R010-GGTACCTT	CAAGCAGAAGACGGCATACGAGATGGTACCTTGTCTCGTGGGCTCGG
R011-GACAGGAT	CAAGCAGAAGACGGCATACGAGATGACAGGATGTCTCGTGGGCTCGG
R012-ACTGGAAC	CAAGCAGAAGACGGCATACGAGATACTGGAACGTCTCGTGGGCTCGG
R013-AACTTCAG	CAAGCAGAAGACGGCATACGAGATAACTTCAGGTCTCGTGGGCTCGG
R014-CTCCAGTT	CAAGCAGAAGACGGCATACGAGATCTCCAGTTGTCTCGTGGGCTCGG
R015-ATCCTGTA	CAAGCAGAAGACGGCATACGAGATATCCTGTAGTCTCGTGGGCTCGG
R016-TCTCACAG	CAAGCAGAAGACGGCATACGAGATTCTCACAGGTCTCGTGGGCTCGG
R017-TCATGCTA	CAAGCAGAAGACGGCATACGAGATTCATGCTAGTCTCGTGGGCTCGG
R018-TGGTCAGA	CAAGCAGAAGACGGCATACGAGATTGGTCAGAGTCTCGTGGGCTCGG
R019-ACCAACTT	CAAGCAGAAGACGGCATACGAGATACCAACTTGTCTCGTGGGCTCGG
R020-ATGCAGAA	CAAGCAGAAGACGGCATACGAGATATGCAGAAGTCTCGTGGGCTCGG
R021-GCTCTCTT	CAAGCAGAAGACGGCATACGAGATGCTCTCTTGTCTCGTGGGCTCGG
R022-GTTGTTCC	CAAGCAGAAGACGGCATACGAGATGTTGTTCCGTCTCGTGGGCTCGG
R023-CTAGTTCG	CAAGCAGAAGACGGCATACGAGATCTAGTTCGGTCTCGTGGGCTCGG
R024-GCTTCTCA	CAAGCAGAAGACGGCATACGAGATGCTTCTCAGTCTCGTGGGCTCGG
R025-GATGAAGA	CAAGCAGAAGACGGCATACGAGATGATGAAGAGTCTCGTGGGCTCGG
R026-TCCAGGTA	CAAGCAGAAGACGGCATACGAGATTCCAGGTAGTCTCGTGGGCTCGG
R027-TGCTTGCT	CAAGCAGAAGACGGCATACGAGATTGCTTGCTGTCTCGTGGGCTCGG
R028-ATCGACCA	CAAGCAGAAGACGGCATACGAGATATCGACCAGTCTCGTGGGCTCGG
R029-TTGGTAGG	CAAGCAGAAGACGGCATACGAGATTTGGTAGGGTCTCGTGGGCTCGG
R030-ACTCTACT	CAAGCAGAAGACGGCATACGAGATACTCTACTGTCTCGTGGGCTCGG
R031-CTCAACGT	CAAGCAGAAGACGGCATACGAGATCTCAACGTGTCTCGTGGGCTCGG
R032-TAGAAGTC	CAAGCAGAAGACGGCATACGAGATTAGAAGTCGTCTCGTGGGCTCGG
R033-AGAGGTAC	CAAGCAGAAGACGGCATACGAGATAGAGGTACGTCTCGTGGGCTCGG
R034-CCTAGCAT	CAAGCAGAAGACGGCATACGAGATCCTAGCATGTCTCGTGGGCTCGG
R035-TACCAGTA	CAAGCAGAAGACGGCATACGAGATTACCAGTAGTCTCGTGGGCTCGG
R036-AGTGCTAG	CAAGCAGAAGACGGCATACGAGATAGTGCTAGGTCTCGTGGGCTCGG
R037-TTCGTCAG	CAAGCAGAAGACGGCATACGAGATTTCGTCAGGTCTCGTGGGCTCGG
R038-TCTCAGCT	CAAGCAGAAGACGGCATACGAGATTCTCAGCTGTCTCGTGGGCTCGG
R039-AGGACTGT	CAAGCAGAAGACGGCATACGAGATAGGACTGTGTCTCGTGGGCTCGG
R040-ATGTCAGT	CAAGCAGAAGACGGCATACGAGATATGTCAGTGTCTCGTGGGCTCGG
R041-GGATCACA	CAAGCAGAAGACGGCATACGAGATGGATCACAGTCTCGTGGGCTCGG
R042-CAACTACA	CAAGCAGAAGACGGCATACGAGATCAACTACAGTCTCGTGGGCTCGG
R043-GAGTGTGA	CAAGCAGAAGACGGCATACGAGATGAGTGTGAGTCTCGTGGGCTCGG
R044-CAAGTGTC	CAAGCAGAAGACGGCATACGAGATCAAGTGTCGTCTCGTGGGCTCGG
R045-CATGTCGA	CAAGCAGAAGACGGCATACGAGATCATGTCGAGTCTCGTGGGCTCGG
R046-CTCACGAT	CAAGCAGAAGACGGCATACGAGATCTCACGATGTCTCGTGGGCTCGG
R047-TACATGAG	CAAGCAGAAGACGGCATACGAGATTACATGAGGTCTCGTGGGCTCGG
R048-TGTCAAGC	CAAGCAGAAGACGGCATACGAGATTGTCAAGCGTCTCGTGGGCTCGG
R049-TGGAGACA	CAAGCAGAAGACGGCATACGAGATTGGAGACAGTCTCGTGGGCTCGG
R050-GACGTCAA	CAAGCAGAAGACGGCATACGAGATGACGTCAAGTCTCGTGGGCTCGG
R051-GGTGAGTA	CAAGCAGAAGACGGCATACGAGATGGTGAGTAGTCTCGTGGGCTCGG
R052-GATCAGTC	CAAGCAGAAGACGGCATACGAGATGATCAGTCGTCTCGTGGGCTCGG
R053-ACACAGGT	CAAGCAGAAGACGGCATACGAGATACACAGGTGTCTCGTGGGCTCGG
R054-CAAGCTAG	CAAGCAGAAGACGGCATACGAGATCAAGCTAGGTCTCGTGGGCTCGG
R055-ATCGTCTT	CAAGCAGAAGACGGCATACGAGATATCGTCTTGTCTCGTGGGCTCGG
R056-CTACACGA	CAAGCAGAAGACGGCATACGAGATCTACACGAGTCTCGTGGGCTCGG
R057-GCTTGAAG	CAAGCAGAAGACGGCATACGAGATGCTTGAAGGTCTCGTGGGCTCGG
R058-CTGAGACT	CAAGCAGAAGACGGCATACGAGATCTGAGACTGTCTCGTGGGCTCGG
R059-CGTACTTG	CAAGCAGAAGACGGCATACGAGATCGTACTTGGTCTCGTGGGCTCGG
R060-TCAGGTCA	CAAGCAGAAGACGGCATACGAGATTCAGGTCAGTCTCGTGGGCTCGG
R061-ATGGACAT	CAAGCAGAAGACGGCATACGAGATATGGACATGTCTCGTGGGCTCGG
R062-GAACCAAC	CAAGCAGAAGACGGCATACGAGATGAACCAACGTCTCGTGGGCTCGG
R063-ATCGATGC	CAAGCAGAAGACGGCATACGAGATATCGATGCGTCTCGTGGGCTCGG
R064-GATGGTCA	CAAGCAGAAGACGGCATACGAGATGATGGTCAGTCTCGTGGGCTCGG
R065-ATCTGTTC	CAAGCAGAAGACGGCATACGAGATATCTGTTCGTCTCGTGGGCTCGG
R066-TGTCAGTG	CAAGCAGAAGACGGCATACGAGATTGTCAGTGGTCTCGTGGGCTCGG
R067-TGTAGAAG	CAAGCAGAAGACGGCATACGAGATTGTAGAAGGTCTCGTGGGCTCGG
R068-TAGCTCGT	CAAGCAGAAGACGGCATACGAGATTAGCTCGTGTCTCGTGGGCTCGG
R069-CATGGTTG	CAAGCAGAAGACGGCATACGAGATCATGGTTGGTCTCGTGGGCTCGG
R070-AGAGGACA	CAAGCAGAAGACGGCATACGAGATAGAGGACAGTCTCGTGGGCTCGG
R071-CAACACTC	CAAGCAGAAGACGGCATACGAGATCAACACTCGTCTCGTGGGCTCGG
R072-TCACATCG	CAAGCAGAAGACGGCATACGAGATTCACATCGGTCTCGTGGGCTCGG
R073-CCTGATGA	CAAGCAGAAGACGGCATACGAGATCCTGATGAGTCTCGTGGGCTCGG
R074-AAGCTCAA	CAAGCAGAAGACGGCATACGAGATAAGCTCAAGTCTCGTGGGCTCGG
R075-GGATGAAC	CAAGCAGAAGACGGCATACGAGATGGATGAACGTCTCGTGGGCTCGG
R076-TAGATCTG	CAAGCAGAAGACGGCATACGAGATTAGATCTGGTCTCGTGGGCTCGG
R077-AACAACAC	CAAGCAGAAGACGGCATACGAGATAACAACACGTCTCGTGGGCTCGG
R078-ATGGTGGT	CAAGCAGAAGACGGCATACGAGATATGGTGGTGTCTCGTGGGCTCGG
R079-TGAACCTA	CAAGCAGAAGACGGCATACGAGATTGAACCTAGTCTCGTGGGCTCGG
R080-TTGAGGTT	CAAGCAGAAGACGGCATACGAGATTTGAGGTTGTCTCGTGGGCTCGG
R081-TCCATGGT	CAAGCAGAAGACGGCATACGAGATTCCATGGTGTCTCGTGGGCTCGG
R082-ACGTCAAG	CAAGCAGAAGACGGCATACGAGATACGTCAAGGTCTCGTGGGCTCGG
R083-CTCTCTAG	CAAGCAGAAGACGGCATACGAGATCTCTCTAGGTCTCGTGGGCTCGG
R084-TGCTCTCA	CAAGCAGAAGACGGCATACGAGATTGCTCTCAGTCTCGTGGGCTCGG
R085-CTCTACAC	CAAGCAGAAGACGGCATACGAGATCTCTACACGTCTCGTGGGCTCGG
R086-GCATGTTC	CAAGCAGAAGACGGCATACGAGATGCATGTTCGTCTCGTGGGCTCGG
R087-GTTCTGTG	CAAGCAGAAGACGGCATACGAGATGTTCTGTGGTCTCGTGGGCTCGG
R088-AGTGACAA	CAAGCAGAAGACGGCATACGAGATAGTGACAAGTCTCGTGGGCTCGG
R089-TGCTTCAA	CAAGCAGAAGACGGCATACGAGATTGCTTCAAGTCTCGTGGGCTCGG
R090-AGATGCTC	CAAGCAGAAGACGGCATACGAGATAGATGCTCGTCTCGTGGGCTCGG
R091-TCTGAAGT	CAAGCAGAAGACGGCATACGAGATTCTGAAGTGTCTCGTGGGCTCGG
R092-CAGCTTCT	CAAGCAGAAGACGGCATACGAGATCAGCTTCTGTCTCGTGGGCTCGG
R093-GAACCTCA	CAAGCAGAAGACGGCATACGAGATGAACCTCAGTCTCGTGGGCTCGG
R094-AAGACGTG	CAAGCAGAAGACGGCATACGAGATAAGACGTGGTCTCGTGGGCTCGG
R095-TGAAGTCG	CAAGCAGAAGACGGCATACGAGATTGAAGTCGGTCTCGTGGGCTCGG
R096-ACTCAAGG	CAAGCAGAAGACGGCATACGAGATACTCAAGGGTCTCGTGGGCTCGG
R097-AGGTTGAG	CAAGCAGAAGACGGCATACGAGATAGGTTGAGGTCTCGTGGGCTCGG
R098-TCCTTCTG	CAAGCAGAAGACGGCATACGAGATTCCTTCTGGTCTCGTGGGCTCGG
R099-TACCACAT	CAAGCAGAAGACGGCATACGAGATTACCACATGTCTCGTGGGCTCGG
R100-CAACAGCT	CAAGCAGAAGACGGCATACGAGATCAACAGCTGTCTCGTGGGCTCGG
R101-TCTTGGTT	CAAGCAGAAGACGGCATACGAGATTCTTGGTTGTCTCGTGGGCTCGG
R102-AAGCACTT	CAAGCAGAAGACGGCATACGAGATAAGCACTTGTCTCGTGGGCTCGG
R103-GTCTTCCA	CAAGCAGAAGACGGCATACGAGATGTCTTCCAGTCTCGTGGGCTCGG
R104-AGCACATC	CAAGCAGAAGACGGCATACGAGATAGCACATCGTCTCGTGGGCTCGG
R105-CTTGCATC	CAAGCAGAAGACGGCATACGAGATCTTGCATCGTCTCGTGGGCTCGG
R106-CACCTTGA	CAAGCAGAAGACGGCATACGAGATCACCTTGAGTCTCGTGGGCTCGG
R107-TGTTGGAC	CAAGCAGAAGACGGCATACGAGATTGTTGGACGTCTCGTGGGCTCGG
R108-TGGACGAA	CAAGCAGAAGACGGCATACGAGATTGGACGAAGTCTCGTGGGCTCGG
R109-GTGAAGTA	CAAGCAGAAGACGGCATACGAGATGTGAAGTAGTCTCGTGGGCTCGG
R110-TAGTGTTC	CAAGCAGAAGACGGCATACGAGATTAGTGTTCGTCTCGTGGGCTCGG
R111-ACTTCCAT	CAAGCAGAAGACGGCATACGAGATACTTCCATGTCTCGTGGGCTCGG
R112-TCAGTCTC	CAAGCAGAAGACGGCATACGAGATTCAGTCTCGTCTCGTGGGCTCGG
R113-AGTCACCT	CAAGCAGAAGACGGCATACGAGATAGTCACCTGTCTCGTGGGCTCGG
R114-ATCAGAGG	CAAGCAGAAGACGGCATACGAGATATCAGAGGGTCTCGTGGGCTCGG
R115-TGACAACT	CAAGCAGAAGACGGCATACGAGATTGACAACTGTCTCGTGGGCTCGG
R116-AGGTAGGA	CAAGCAGAAGACGGCATACGAGATAGGTAGGAGTCTCGTGGGCTCGG
R117-TCTGGTAG	CAAGCAGAAGACGGCATACGAGATTCTGGTAGGTCTCGTGGGCTCGG
R118-TTCAGACC	CAAGCAGAAGACGGCATACGAGATTTCAGACCGTCTCGTGGGCTCGG
R119-CAACCTGT	CAAGCAGAAGACGGCATACGAGATCAACCTGTGTCTCGTGGGCTCGG
R120-ACATGGAC	CAAGCAGAAGACGGCATACGAGATACATGGACGTCTCGTGGGCTCGG
R121-ACAAGCAA	CAAGCAGAAGACGGCATACGAGATACAAGCAAGTCTCGTGGGCTCGG
R122-AGACACTG	CAAGCAGAAGACGGCATACGAGATAGACACTGGTCTCGTGGGCTCGG
R123-TTCTGAGA	CAAGCAGAAGACGGCATACGAGATTTCTGAGAGTCTCGTGGGCTCGG
R124-TGGTCTTG	CAAGCAGAAGACGGCATACGAGATTGGTCTTGGTCTCGTGGGCTCGG
R125-TTGAAGAG	CAAGCAGAAGACGGCATACGAGATTTGAAGAGGTCTCGTGGGCTCGG
R126-GTGAGTTG	CAAGCAGAAGACGGCATACGAGATGTGAGTTGGTCTCGTGGGCTCGG
R127-TCCAAGAC	CAAGCAGAAGACGGCATACGAGATTCCAAGACGTCTCGTGGGCTCGG
R128-CCTCTAGA	CAAGCAGAAGACGGCATACGAGATCCTCTAGAGTCTCGTGGGCTCGG
R129-AAGTTGCA	CAAGCAGAAGACGGCATACGAGATAAGTTGCAGTCTCGTGGGCTCGG
R130-TTCTCCTA	CAAGCAGAAGACGGCATACGAGATTTCTCCTAGTCTCGTGGGCTCGG
R131-AACTCGAT	CAAGCAGAAGACGGCATACGAGATAACTCGATGTCTCGTGGGCTCGG
R132-CATGGACT	CAAGCAGAAGACGGCATACGAGATCATGGACTGTCTCGTGGGCTCGG
R133-TCGATGCA	CAAGCAGAAGACGGCATACGAGATTCGATGCAGTCTCGTGGGCTCGG
R134-ACTGCACA	CAAGCAGAAGACGGCATACGAGATACTGCACAGTCTCGTGGGCTCGG
R135-GTCCTCAT	CAAGCAGAAGACGGCATACGAGATGTCCTCATGTCTCGTGGGCTCGG
R136-CTTCTCTC	CAAGCAGAAGACGGCATACGAGATCTTCTCTCGTCTCGTGGGCTCGG
R137-GGAAGGAA	CAAGCAGAAGACGGCATACGAGATGGAAGGAAGTCTCGTGGGCTCGG
R138-GATGTGCT	CAAGCAGAAGACGGCATACGAGATGATGTGCTGTCTCGTGGGCTCGG
R139-AACTCTTG	CAAGCAGAAGACGGCATACGAGATAACTCTTGGTCTCGTGGGCTCGG
R140-AAGGAACG	CAAGCAGAAGACGGCATACGAGATAAGGAACGGTCTCGTGGGCTCGG
R141-GTCACAGA	CAAGCAGAAGACGGCATACGAGATGTCACAGAGTCTCGTGGGCTCGG
R142-CACTAGTG	CAAGCAGAAGACGGCATACGAGATCACTAGTGGTCTCGTGGGCTCGG
R143-AGAGAGTC	CAAGCAGAAGACGGCATACGAGATAGAGAGTCGTCTCGTGGGCTCGG
R144-GTGATCTT	CAAGCAGAAGACGGCATACGAGATGTGATCTTGTCTCGTGGGCTCGG
R145-AACAGACT	CAAGCAGAAGACGGCATACGAGATAACAGACTGTCTCGTGGGCTCGG
R146-GAAGCAGT	CAAGCAGAAGACGGCATACGAGATGAAGCAGTGTCTCGTGGGCTCGG
R147-AAGAGGAA	CAAGCAGAAGACGGCATACGAGATAAGAGGAAGTCTCGTGGGCTCGG
R148-ACAGAGAA	CAAGCAGAAGACGGCATACGAGATACAGAGAAGTCTCGTGGGCTCGG
R149-TTCCTAGC	CAAGCAGAAGACGGCATACGAGATTTCCTAGCGTCTCGTGGGCTCGG
R150-GTAGTCTG	CAAGCAGAAGACGGCATACGAGATGTAGTCTGGTCTCGTGGGCTCGG
R151-TTGGTCCA	CAAGCAGAAGACGGCATACGAGATTTGGTCCAGTCTCGTGGGCTCGG
R152-CTGTACCT	CAAGCAGAAGACGGCATACGAGATCTGTACCTGTCTCGTGGGCTCGG
R153-AACCAGAG	CAAGCAGAAGACGGCATACGAGATAACCAGAGGTCTCGTGGGCTCGG
R154-AGTACGTA	CAAGCAGAAGACGGCATACGAGATAGTACGTAGTCTCGTGGGCTCGG
R155-TAGGATGG	CAAGCAGAAGACGGCATACGAGATTAGGATGGGTCTCGTGGGCTCGG
R156-TTGCTTGA	CAAGCAGAAGACGGCATACGAGATTTGCTTGAGTCTCGTGGGCTCGG
R157-AGATCTGG	CAAGCAGAAGACGGCATACGAGATAGATCTGGGTCTCGTGGGCTCGG
R158-ACCTTGGA	CAAGCAGAAGACGGCATACGAGATACCTTGGAGTCTCGTGGGCTCGG
R159-GTGGTGAA	CAAGCAGAAGACGGCATACGAGATGTGGTGAAGTCTCGTGGGCTCGG
R160-TAGTCGTA	CAAGCAGAAGACGGCATACGAGATTAGTCGTAGTCTCGTGGGCTCGG
R161-GTTGGAGT	CAAGCAGAAGACGGCATACGAGATGTTGGAGTGTCTCGTGGGCTCGG
R162-ACAAGGTT	CAAGCAGAAGACGGCATACGAGATACAAGGTTGTCTCGTGGGCTCGG
R163-AGCTCCTT	CAAGCAGAAGACGGCATACGAGATAGCTCCTTGTCTCGTGGGCTCGG
R164-ACAACTCA	CAAGCAGAAGACGGCATACGAGATACAACTCAGTCTCGTGGGCTCGG
R165-CATCGAAG	CAAGCAGAAGACGGCATACGAGATCATCGAAGGTCTCGTGGGCTCGG
R166-GTGCTACA	CAAGCAGAAGACGGCATACGAGATGTGCTACAGTCTCGTGGGCTCGG
R167-GTGACAAC	CAAGCAGAAGACGGCATACGAGATGTGACAACGTCTCGTGGGCTCGG
R168-GAACAACG	CAAGCAGAAGACGGCATACGAGATGAACAACGGTCTCGTGGGCTCGG
R169-TACACAGC	CAAGCAGAAGACGGCATACGAGATTACACAGCGTCTCGTGGGCTCGG
R170-TCTTCGAG	CAAGCAGAAGACGGCATACGAGATTCTTCGAGGTCTCGTGGGCTCGG
R171-CATCAAGT	CAAGCAGAAGACGGCATACGAGATCATCAAGTGTCTCGTGGGCTCGG
R172-GCTAGTAC	CAAGCAGAAGACGGCATACGAGATGCTAGTACGTCTCGTGGGCTCGG
R173-TCTTGACC	CAAGCAGAAGACGGCATACGAGATTCTTGACCGTCTCGTGGGCTCGG
R174-AGAACGAG	CAAGCAGAAGACGGCATACGAGATAGAACGAGGTCTCGTGGGCTCGG
R175-TGTCTTGG	CAAGCAGAAGACGGCATACGAGATTGTCTTGGGTCTCGTGGGCTCGG
R176-TGCATGTC	CAAGCAGAAGACGGCATACGAGATTGCATGTCGTCTCGTGGGCTCGG
R177-AGATCCAA	CAAGCAGAAGACGGCATACGAGATAGATCCAAGTCTCGTGGGCTCGG
R178-AAGTCTCT	CAAGCAGAAGACGGCATACGAGATAAGTCTCTGTCTCGTGGGCTCGG
R179-AGAGTAGT	CAAGCAGAAGACGGCATACGAGATAGAGTAGTGTCTCGTGGGCTCGG
R180-CTAGGAGA	CAAGCAGAAGACGGCATACGAGATCTAGGAGAGTCTCGTGGGCTCGG
R181-TGCTACGT	CAAGCAGAAGACGGCATACGAGATTGCTACGTGTCTCGTGGGCTCGG
R182-GTTGCTGA	CAAGCAGAAGACGGCATACGAGATGTTGCTGAGTCTCGTGGGCTCGG
R183-ACTCGTGA	CAAGCAGAAGACGGCATACGAGATACTCGTGAGTCTCGTGGGCTCGG
R184-TGCAGCTT	CAAGCAGAAGACGGCATACGAGATTGCAGCTTGTCTCGTGGGCTCGG
R185-CAGTGATG	CAAGCAGAAGACGGCATACGAGATCAGTGATGGTCTCGTGGGCTCGG
R186-AAGTAGAC	CAAGCAGAAGACGGCATACGAGATAAGTAGACGTCTCGTGGGCTCGG
R187-GAAGTACC	CAAGCAGAAGACGGCATACGAGATGAAGTACCGTCTCGTGGGCTCGG
R188-AGACTCAT	CAAGCAGAAGACGGCATACGAGATAGACTCATGTCTCGTGGGCTCGG
R189-ACACGTCT	CAAGCAGAAGACGGCATACGAGATACACGTCTGTCTCGTGGGCTCGG
R190-AAGACCAT	CAAGCAGAAGACGGCATACGAGATAAGACCATGTCTCGTGGGCTCGG
R191-GGAACTAC	CAAGCAGAAGACGGCATACGAGATGGAACTACGTCTCGTGGGCTCGG
R192-TTGTCTGC	CAAGCAGAAGACGGCATACGAGATTTGTCTGCGTCTCGTGGGCTCGG
R193-CTTCAACC	CAAGCAGAAGACGGCATACGAGATCTTCAACCGTCTCGTGGGCTCGG
R194-CTGTGTAC	CAAGCAGAAGACGGCATACGAGATCTGTGTACGTCTCGTGGGCTCGG
R195-GAAGCTTC	CAAGCAGAAGACGGCATACGAGATGAAGCTTCGTCTCGTGGGCTCGG
R196-CTGGACTA	CAAGCAGAAGACGGCATACGAGATCTGGACTAGTCTCGTGGGCTCGG
R197-GGTGTCAT	CAAGCAGAAGACGGCATACGAGATGGTGTCATGTCTCGTGGGCTCGG
R198-ACCACAGT	CAAGCAGAAGACGGCATACGAGATACCACAGTGTCTCGTGGGCTCGG
R199-TTCATCCT	CAAGCAGAAGACGGCATACGAGATTTCATCCTGTCTCGTGGGCTCGG
R200-GAAGTTGA	CAAGCAGAAGACGGCATACGAGATGAAGTTGAGTCTCGTGGGCTCGG
R201-TTGCAGGT	CAAGCAGAAGACGGCATACGAGATTTGCAGGTGTCTCGTGGGCTCGG
R202-AACCACGA	CAAGCAGAAGACGGCATACGAGATAACCACGAGTCTCGTGGGCTCGG
R203-ACCAGTAG	CAAGCAGAAGACGGCATACGAGATACCAGTAGGTCTCGTGGGCTCGG
R204-TAGGTGAT	CAAGCAGAAGACGGCATACGAGATTAGGTGATGTCTCGTGGGCTCGG
R205-CTGTCTCA	CAAGCAGAAGACGGCATACGAGATCTGTCTCAGTCTCGTGGGCTCGG
R206-GTAGGAAG	CAAGCAGAAGACGGCATACGAGATGTAGGAAGGTCTCGTGGGCTCGG
R207-ACGACTTC	CAAGCAGAAGACGGCATACGAGATACGACTTCGTCTCGTGGGCTCGG
R208-GAAGATCT	CAAGCAGAAGACGGCATACGAGATGAAGATCTGTCTCGTGGGCTCGG
R209-GAGCTGTT	CAAGCAGAAGACGGCATACGAGATGAGCTGTTGTCTCGTGGGCTCGG
R210-ATGCTCTG	CAAGCAGAAGACGGCATACGAGATATGCTCTGGTCTCGTGGGCTCGG
R211-CAAGTAGG	CAAGCAGAAGACGGCATACGAGATCAAGTAGGGTCTCGTGGGCTCGG
R212-ACCTACAA	CAAGCAGAAGACGGCATACGAGATACCTACAAGTCTCGTGGGCTCGG
R213-GAGTACAT	CAAGCAGAAGACGGCATACGAGATGAGTACATGTCTCGTGGGCTCGG
R214-AGACCTTC	CAAGCAGAAGACGGCATACGAGATAGACCTTCGTCTCGTGGGCTCGG
R215-TGAAGCAC	CAAGCAGAAGACGGCATACGAGATTGAAGCACGTCTCGTGGGCTCGG
R216-TGTAGTTC	CAAGCAGAAGACGGCATACGAGATTGTAGTTCGTCTCGTGGGCTCGG
R217-AACGTGAC	CAAGCAGAAGACGGCATACGAGATAACGTGACGTCTCGTGGGCTCGG
R218-GGTTGAGA	CAAGCAGAAGACGGCATACGAGATGGTTGAGAGTCTCGTGGGCTCGG
R219-TCCTCATC	CAAGCAGAAGACGGCATACGAGATTCCTCATCGTCTCGTGGGCTCGG
R220-CAGATCCA	CAAGCAGAAGACGGCATACGAGATCAGATCCAGTCTCGTGGGCTCGG
R221-GTTCATCT	CAAGCAGAAGACGGCATACGAGATGTTCATCTGTCTCGTGGGCTCGG
R222-AGTGAGGT	CAAGCAGAAGACGGCATACGAGATAGTGAGGTGTCTCGTGGGCTCGG
R223-ATGTGACA	CAAGCAGAAGACGGCATACGAGATATGTGACAGTCTCGTGGGCTCGG
R224-ATCAGCAT	CAAGCAGAAGACGGCATACGAGATATCAGCATGTCTCGTGGGCTCGG
R225-CCTACAAG	CAAGCAGAAGACGGCATACGAGATCCTACAAGGTCTCGTGGGCTCGG
R226-GTACCTTG	CAAGCAGAAGACGGCATACGAGATGTACCTTGGTCTCGTGGGCTCGG
R227-TCCACTTG	CAAGCAGAAGACGGCATACGAGATTCCACTTGGTCTCGTGGGCTCGG
R228-GCAGTGTA	CAAGCAGAAGACGGCATACGAGATGCAGTGTAGTCTCGTGGGCTCGG
R229-AGGATGCT	CAAGCAGAAGACGGCATACGAGATAGGATGCTGTCTCGTGGGCTCGG
R230-AGCTGAGT	CAAGCAGAAGACGGCATACGAGATAGCTGAGTGTCTCGTGGGCTCGG
R231-TTGGTGTC	CAAGCAGAAGACGGCATACGAGATTTGGTGTCGTCTCGTGGGCTCGG
R232-TAGCAAGA	CAAGCAGAAGACGGCATACGAGATTAGCAAGAGTCTCGTGGGCTCGG
R233-GTCAACAA	CAAGCAGAAGACGGCATACGAGATGTCAACAAGTCTCGTGGGCTCGG
R234-TCTCTGTC	CAAGCAGAAGACGGCATACGAGATTCTCTGTCGTCTCGTGGGCTCGG
R235-TCCTGCAT	CAAGCAGAAGACGGCATACGAGATTCCTGCATGTCTCGTGGGCTCGG
R236-CAAGACCA	CAAGCAGAAGACGGCATACGAGATCAAGACCAGTCTCGTGGGCTCGG
R237-TTGTCGAT	CAAGCAGAAGACGGCATACGAGATTTGTCGATGTCTCGTGGGCTCGG
R238-ACATCGTA	CAAGCAGAAGACGGCATACGAGATACATCGTAGTCTCGTGGGCTCGG
R239-CTTCGTGT	CAAGCAGAAGACGGCATACGAGATCTTCGTGTGTCTCGTGGGCTCGG
R240-AACACAAG	CAAGCAGAAGACGGCATACGAGATAACACAAGGTCTCGTGGGCTCGG
R241-TCGAACTA	CAAGCAGAAGACGGCATACGAGATTCGAACTAGTCTCGTGGGCTCGG
R242-TACTGTAG	CAAGCAGAAGACGGCATACGAGATTACTGTAGGTCTCGTGGGCTCGG
R243-GATCCACT	CAAGCAGAAGACGGCATACGAGATGATCCACTGTCTCGTGGGCTCGG
R244-CGAAGTGA	CAAGCAGAAGACGGCATACGAGATCGAAGTGAGTCTCGTGGGCTCGG
R245-GGATGTCT	CAAGCAGAAGACGGCATACGAGATGGATGTCTGTCTCGTGGGCTCGG
R246-TGAGAAGG	CAAGCAGAAGACGGCATACGAGATTGAGAAGGGTCTCGTGGGCTCGG
R247-ACAGTTCC	CAAGCAGAAGACGGCATACGAGATACAGTTCCGTCTCGTGGGCTCGG
R248-CATCCTTC	CAAGCAGAAGACGGCATACGAGATCATCCTTCGTCTCGTGGGCTCGG
R249-CTGTTCAG	CAAGCAGAAGACGGCATACGAGATCTGTTCAGGTCTCGTGGGCTCGG
R250-CGTAGCTA	CAAGCAGAAGACGGCATACGAGATCGTAGCTAGTCTCGTGGGCTCGG
R251-AGAACAGA	CAAGCAGAAGACGGCATACGAGATAGAACAGAGTCTCGTGGGCTCGG
R252-GCTGAGAT	CAAGCAGAAGACGGCATACGAGATGCTGAGATGTCTCGTGGGCTCGG
R253-GGAAGAGT	CAAGCAGAAGACGGCATACGAGATGGAAGAGTGTCTCGTGGGCTCGG
R254-TCTAGAGA	CAAGCAGAAGACGGCATACGAGATTCTAGAGAGTCTCGTGGGCTCGG
R255-ACGTTCTC	CAAGCAGAAGACGGCATACGAGATACGTTCTCGTCTCGTGGGCTCGG
R256-GTAGAGGT	CAAGCAGAAGACGGCATACGAGATGTAGAGGTGTCTCGTGGGCTCGG
R257-TACCTCCA	CAAGCAGAAGACGGCATACGAGATTACCTCCAGTCTCGTGGGCTCGG
R258-CTTGAGCA	CAAGCAGAAGACGGCATACGAGATCTTGAGCAGTCTCGTGGGCTCGG
R259-AGCTGGAA	CAAGCAGAAGACGGCATACGAGATAGCTGGAAGTCTCGTGGGCTCGG
R260-TGTCCACA	CAAGCAGAAGACGGCATACGAGATTGTCCACAGTCTCGTGGGCTCGG
R261-CACTTGGT	CAAGCAGAAGACGGCATACGAGATCACTTGGTGTCTCGTGGGCTCGG
R262-ACAGCTGT	CAAGCAGAAGACGGCATACGAGATACAGCTGTGTCTCGTGGGCTCGG
R263-GTGACTCT	CAAGCAGAAGACGGCATACGAGATGTGACTCTGTCTCGTGGGCTCGG
R264-ACGAACAG	CAAGCAGAAGACGGCATACGAGATACGAACAGGTCTCGTGGGCTCGG
R265-GAAGAGTG	CAAGCAGAAGACGGCATACGAGATGAAGAGTGGTCTCGTGGGCTCGG
R266-CCACAGTA	CAAGCAGAAGACGGCATACGAGATCCACAGTAGTCTCGTGGGCTCGG
R267-GATGACTT	CAAGCAGAAGACGGCATACGAGATGATGACTTGTCTCGTGGGCTCGG
R268-CAGACAGT	CAAGCAGAAGACGGCATACGAGATCAGACAGTGTCTCGTGGGCTCGG
R269-AGAGATCG	CAAGCAGAAGACGGCATACGAGATAGAGATCGGTCTCGTGGGCTCGG
R270-GGTTCGAA	CAAGCAGAAGACGGCATACGAGATGGTTCGAAGTCTCGTGGGCTCGG
R271-AACCTCTC	CAAGCAGAAGACGGCATACGAGATAACCTCTCGTCTCGTGGGCTCGG
R272-AGTAGTCA	CAAGCAGAAGACGGCATACGAGATAGTAGTCAGTCTCGTGGGCTCGG
R273-TTGTGAAG	CAAGCAGAAGACGGCATACGAGATTTGTGAAGGTCTCGTGGGCTCGG
R274-GAACTCTA	CAAGCAGAAGACGGCATACGAGATGAACTCTAGTCTCGTGGGCTCGG
R275-TGTCTCAC	CAAGCAGAAGACGGCATACGAGATTGTCTCACGTCTCGTGGGCTCGG
R276-CGATGTAG	CAAGCAGAAGACGGCATACGAGATCGATGTAGGTCTCGTGGGCTCGG
R277-TGACTAGA	CAAGCAGAAGACGGCATACGAGATTGACTAGAGTCTCGTGGGCTCGG
R278-AGTCCAGT	CAAGCAGAAGACGGCATACGAGATAGTCCAGTGTCTCGTGGGCTCGG
R279-GATCTCAG	CAAGCAGAAGACGGCATACGAGATGATCTCAGGTCTCGTGGGCTCGG
R280-ATCTAGGT	CAAGCAGAAGACGGCATACGAGATATCTAGGTGTCTCGTGGGCTCGG
R281-CTTGTGAG	CAAGCAGAAGACGGCATACGAGATCTTGTGAGGTCTCGTGGGCTCGG
R282-ACAACAAC	CAAGCAGAAGACGGCATACGAGATACAACAACGTCTCGTGGGCTCGG
R283-ATGTGGTG	CAAGCAGAAGACGGCATACGAGATATGTGGTGGTCTCGTGGGCTCGG
R284-TCTCTTCA	CAAGCAGAAGACGGCATACGAGATTCTCTTCAGTCTCGTGGGCTCGG
R285-TACAGCAA	CAAGCAGAAGACGGCATACGAGATTACAGCAAGTCTCGTGGGCTCGG
R286-GTCTCGTT	CAAGCAGAAGACGGCATACGAGATGTCTCGTTGTCTCGTGGGCTCGG
R287-CCTTCCTA	CAAGCAGAAGACGGCATACGAGATCCTTCCTAGTCTCGTGGGCTCGG
R288-TCCTAGCA	CAAGCAGAAGACGGCATACGAGATTCCTAGCAGTCTCGTGGGCTCGG
R289-AGTACCAC	CAAGCAGAAGACGGCATACGAGATAGTACCACGTCTCGTGGGCTCGG
R290-GTGTGATC	CAAGCAGAAGACGGCATACGAGATGTGTGATCGTCTCGTGGGCTCGG
R291-AAGAGTCG	CAAGCAGAAGACGGCATACGAGATAAGAGTCGGTCTCGTGGGCTCGG
R292-GACTAGGA	CAAGCAGAAGACGGCATACGAGATGACTAGGAGTCTCGTGGGCTCGG
R293-TCACACTT	CAAGCAGAAGACGGCATACGAGATTCACACTTGTCTCGTGGGCTCGG
R294-CTAGCACT	CAAGCAGAAGACGGCATACGAGATCTAGCACTGTCTCGTGGGCTCGG
R295-TCATCTCC	CAAGCAGAAGACGGCATACGAGATTCATCTCCGTCTCGTGGGCTCGG
R296-TCAAGGAG	CAAGCAGAAGACGGCATACGAGATTCAAGGAGGTCTCGTGGGCTCGG
R297-CGTGTTCT	CAAGCAGAAGACGGCATACGAGATCGTGTTCTGTCTCGTGGGCTCGG
R298-ACTCACTA	CAAGCAGAAGACGGCATACGAGATACTCACTAGTCTCGTGGGCTCGG
R299-ATGATCGA	CAAGCAGAAGACGGCATACGAGATATGATCGAGTCTCGTGGGCTCGG
R300-TGAGTGTG	CAAGCAGAAGACGGCATACGAGATTGAGTGTGGTCTCGTGGGCTCGG
R301-GTCACTTC	CAAGCAGAAGACGGCATACGAGATGTCACTTCGTCTCGTGGGCTCGG
R302-ACACAACA	CAAGCAGAAGACGGCATACGAGATACACAACAGTCTCGTGGGCTCGG
R303-GAGAGAAG	CAAGCAGAAGACGGCATACGAGATGAGAGAAGGTCTCGTGGGCTCGG
R304-GACTGACA	CAAGCAGAAGACGGCATACGAGATGACTGACAGTCTCGTGGGCTCGG
R305-TCGTCCTT	CAAGCAGAAGACGGCATACGAGATTCGTCCTTGTCTCGTGGGCTCGG
R306-AGTGTGCA	CAAGCAGAAGACGGCATACGAGATAGTGTGCAGTCTCGTGGGCTCGG
R307-ACCTAGTC	CAAGCAGAAGACGGCATACGAGATACCTAGTCGTCTCGTGGGCTCGG
R308-TAGTCCAG	CAAGCAGAAGACGGCATACGAGATTAGTCCAGGTCTCGTGGGCTCGG
R309-CTGCTGAT	CAAGCAGAAGACGGCATACGAGATCTGCTGATGTCTCGTGGGCTCGG
R310-AGACATGA	CAAGCAGAAGACGGCATACGAGATAGACATGAGTCTCGTGGGCTCGG
R311-TGAGGTGT	CAAGCAGAAGACGGCATACGAGATTGAGGTGTGTCTCGTGGGCTCGG
R312-AGGAGATG	CAAGCAGAAGACGGCATACGAGATAGGAGATGGTCTCGTGGGCTCGG
R313-GAGAACGA	CAAGCAGAAGACGGCATACGAGATGAGAACGAGTCTCGTGGGCTCGG
R314-TCATGTGG	CAAGCAGAAGACGGCATACGAGATTCATGTGGGTCTCGTGGGCTCGG
R315-CTCGATCT	CAAGCAGAAGACGGCATACGAGATCTCGATCTGTCTCGTGGGCTCGG
R316-CAAGATGC	CAAGCAGAAGACGGCATACGAGATCAAGATGCGTCTCGTGGGCTCGG
R317-GTGTTGCT	CAAGCAGAAGACGGCATACGAGATGTGTTGCTGTCTCGTGGGCTCGG
R318-CTCATCTA	CAAGCAGAAGACGGCATACGAGATCTCATCTAGTCTCGTGGGCTCGG
R319-TAGACTAC	CAAGCAGAAGACGGCATACGAGATTAGACTACGTCTCGTGGGCTCGG
R320-TGAGTCCT	CAAGCAGAAGACGGCATACGAGATTGAGTCCTGTCTCGTGGGCTCGG
R321-CTGATGTG	CAAGCAGAAGACGGCATACGAGATCTGATGTGGTCTCGTGGGCTCGG
R322-CGTTCAAC	CAAGCAGAAGACGGCATACGAGATCGTTCAACGTCTCGTGGGCTCGG
R323-TCTCGATG	CAAGCAGAAGACGGCATACGAGATTCTCGATGGTCTCGTGGGCTCGG
R324-AACCAACC	CAAGCAGAAGACGGCATACGAGATAACCAACCGTCTCGTGGGCTCGG
R325-CTGTTGGA	CAAGCAGAAGACGGCATACGAGATCTGTTGGAGTCTCGTGGGCTCGG
R326-ACTCTGAA	CAAGCAGAAGACGGCATACGAGATACTCTGAAGTCTCGTGGGCTCGG
R327-AACAGTGA	CAAGCAGAAGACGGCATACGAGATAACAGTGAGTCTCGTGGGCTCGG
R328-GTTCTCGA	CAAGCAGAAGACGGCATACGAGATGTTCTCGAGTCTCGTGGGCTCGG
R329-CTGTAGTC	CAAGCAGAAGACGGCATACGAGATCTGTAGTCGTCTCGTGGGCTCGG
R330-TGGATCAT	CAAGCAGAAGACGGCATACGAGATTGGATCATGTCTCGTGGGCTCGG
R331-GCATCGAT	CAAGCAGAAGACGGCATACGAGATGCATCGATGTCTCGTGGGCTCGG
R332-CAAGTCAT	CAAGCAGAAGACGGCATACGAGATCAAGTCATGTCTCGTGGGCTCGG
R333-TCAACAGG	CAAGCAGAAGACGGCATACGAGATTCAACAGGGTCTCGTGGGCTCGG
R334-TGATCGTT	CAAGCAGAAGACGGCATACGAGATTGATCGTTGTCTCGTGGGCTCGG
R335-TAGAACCT	CAAGCAGAAGACGGCATACGAGATTAGAACCTGTCTCGTGGGCTCGG
R336-ATCTCACC	CAAGCAGAAGACGGCATACGAGATATCTCACCGTCTCGTGGGCTCGG
R337-AGTCTGTT	CAAGCAGAAGACGGCATACGAGATAGTCTGTTGTCTCGTGGGCTCGG
R338-AGGTGCAT	CAAGCAGAAGACGGCATACGAGATAGGTGCATGTCTCGTGGGCTCGG
R339-GCATCATG	CAAGCAGAAGACGGCATACGAGATGCATCATGGTCTCGTGGGCTCGG
R340-TGTGATCA	CAAGCAGAAGACGGCATACGAGATTGTGATCAGTCTCGTGGGCTCGG
R341-TCGAGAAC	CAAGCAGAAGACGGCATACGAGATTCGAGAACGTCTCGTGGGCTCGG
R342-CGAGTGAA	CAAGCAGAAGACGGCATACGAGATCGAGTGAAGTCTCGTGGGCTCGG
R343-TCAGACGA	CAAGCAGAAGACGGCATACGAGATTCAGACGAGTCTCGTGGGCTCGG
R344-TTCCACTG	CAAGCAGAAGACGGCATACGAGATTTCCACTGGTCTCGTGGGCTCGG
R345-GAGATCAC	CAAGCAGAAGACGGCATACGAGATGAGATCACGTCTCGTGGGCTCGG
R346-ACGTCTGA	CAAGCAGAAGACGGCATACGAGATACGTCTGAGTCTCGTGGGCTCGG
R347-ACACTGTG	CAAGCAGAAGACGGCATACGAGATACACTGTGGTCTCGTGGGCTCGG
R348-AGCAAGAT	CAAGCAGAAGACGGCATACGAGATAGCAAGATGTCTCGTGGGCTCGG
R349-AGAGTCTA	CAAGCAGAAGACGGCATACGAGATAGAGTCTAGTCTCGTGGGCTCGG
R350-TTCCAACA	CAAGCAGAAGACGGCATACGAGATTTCCAACAGTCTCGTGGGCTCGG
R351-GTGTGCAA	CAAGCAGAAGACGGCATACGAGATGTGTGCAAGTCTCGTGGGCTCGG
R352-CCTACGTT	CAAGCAGAAGACGGCATACGAGATCCTACGTTGTCTCGTGGGCTCGG
R353-TACGTTCC	CAAGCAGAAGACGGCATACGAGATTACGTTCCGTCTCGTGGGCTCGG
R354-ATGACTAG	CAAGCAGAAGACGGCATACGAGATATGACTAGGTCTCGTGGGCTCGG
R355-TGTGACTC	CAAGCAGAAGACGGCATACGAGATTGTGACTCGTCTCGTGGGCTCGG
R356-AGTCGTTG	CAAGCAGAAGACGGCATACGAGATAGTCGTTGGTCTCGTGGGCTCGG
R357-TACACGTT	CAAGCAGAAGACGGCATACGAGATTACACGTTGTCTCGTGGGCTCGG
R358-CATGACAG	CAAGCAGAAGACGGCATACGAGATCATGACAGGTCTCGTGGGCTCGG
R359-AACTGAAC	CAAGCAGAAGACGGCATACGAGATAACTGAACGTCTCGTGGGCTCGG
R360-GCACTTGT	CAAGCAGAAGACGGCATACGAGATGCACTTGTGTCTCGTGGGCTCGG
R361-TTGACACG	CAAGCAGAAGACGGCATACGAGATTTGACACGGTCTCGTGGGCTCGG
R362-ACAAGTGC	CAAGCAGAAGACGGCATACGAGATACAAGTGCGTCTCGTGGGCTCGG
R363-AGTGTTGC	CAAGCAGAAGACGGCATACGAGATAGTGTTGCGTCTCGTGGGCTCGG
R364-GTACACAG	CAAGCAGAAGACGGCATACGAGATGTACACAGGTCTCGTGGGCTCGG
R365-TCTCCAAC	CAAGCAGAAGACGGCATACGAGATTCTCCAACGTCTCGTGGGCTCGG
R366-CTAGGTTC	CAAGCAGAAGACGGCATACGAGATCTAGGTTCGTCTCGTGGGCTCGG
R367-AACTCAGA	CAAGCAGAAGACGGCATACGAGATAACTCAGAGTCTCGTGGGCTCGG
R368-TGAGAGAT	CAAGCAGAAGACGGCATACGAGATTGAGAGATGTCTCGTGGGCTCGG
R369-TAGTGACT	CAAGCAGAAGACGGCATACGAGATTAGTGACTGTCTCGTGGGCTCGG
R370-AAGAAGGT	CAAGCAGAAGACGGCATACGAGATAAGAAGGTGTCTCGTGGGCTCGG
R371-TCGTGGAA	CAAGCAGAAGACGGCATACGAGATTCGTGGAAGTCTCGTGGGCTCGG
R372-CTACTAGT	CAAGCAGAAGACGGCATACGAGATCTACTAGTGTCTCGTGGGCTCGG
R373-AACGAAGT	CAAGCAGAAGACGGCATACGAGATAACGAAGTGTCTCGTGGGCTCGG
R374-TAGGACAA	CAAGCAGAAGACGGCATACGAGATTAGGACAAGTCTCGTGGGCTCGG
R375-ATCCTTGT	CAAGCAGAAGACGGCATACGAGATATCCTTGTGTCTCGTGGGCTCGG
R376-AGGAACCA	CAAGCAGAAGACGGCATACGAGATAGGAACCAGTCTCGTGGGCTCGG
R377-ATGGAAGA	CAAGCAGAAGACGGCATACGAGATATGGAAGAGTCTCGTGGGCTCGG
R378-TCGTAGTG	CAAGCAGAAGACGGCATACGAGATTCGTAGTGGTCTCGTGGGCTCGG
R379-GAACGTAG	CAAGCAGAAGACGGCATACGAGATGAACGTAGGTCTCGTGGGCTCGG
R380-GTACTGAC	CAAGCAGAAGACGGCATACGAGATGTACTGACGTCTCGTGGGCTCGG
R381-ACCTGATG	CAAGCAGAAGACGGCATACGAGATACCTGATGGTCTCGTGGGCTCGG
R382-TGTCGTCT	CAAGCAGAAGACGGCATACGAGATTGTCGTCTGTCTCGTGGGCTCGG
R383-CAAGGAAC	CAAGCAGAAGACGGCATACGAGATCAAGGAACGTCTCGTGGGCTCGG
R384-TGTACTGA	CAAGCAGAAGACGGCATACGAGATTGTACTGAGTCTCGTGGGCTCGG
